sincerest	sɪn.'seɪ.ʌ.ɹʌst
flask-basicauth	'flæsk.'beɪ.sɪ.'kɔːθ
flask-login	'flæ.'sklɑ.ɡɪn
flask-oidc	'flæ.'skɔɪdk
flask-session	'flæsk.'sɛ.ʃʌn
flask-wtf	'flæsk.`dʌ.bʌl.`jʉː.`ti.'ɛf
gevent	'dʒɛ.vɛnt
gevent-websocket	'dʒɛ.vɛn.'twɛb.sɑ.kɪt
greenlet	'ɡɹin.lʌt
httplib2	`eɪtʃ.`ti.'ti.'plɪb.'tʉː
itsdangerous	ɪts.'deɪn.dʒʌ.ɹʌs
jinja2	'dʒɪn.jʌ.'tʉː
markupsafe	'mɑ.kʌp.'seɪf
nltk	`ɛ.`nɛl.`ti.'keɪ
numpy	'nʌm.pɪ
oauth2client	'əʊ.ʌθ.'tʉː.'klaɪ.ʌnt
pyasn1	'paɪ.æ.sʌn.'wɑn
pyasn1-modules	'paɪ.æ.sʌn.'wɑn.'mɑd.jʉːlz
flask-socketio==4.3.1	'flæsk.'sɑ.kɪ.`taɪ.'əʊ.'i.kwʌl.`zi.kwʌlz.'fɔː.pɔɪnt.'θɹi.pɔɪn.'twɑn
python-engineio==3.13.2	'paɪ.θʌ.'nɛn.dʒɪ.`neɪ.əʊ.'i.kwʌl.`zi.kwʌlz.'θɹi.pɔɪn.'twɑn.'θɹi.pɔɪnt.'tʉː
python-socketio==4.6.0	'paɪ.θʌn.sʌ.'ki.tɪ.`əʊ.'i.kwʌl.`zi.kwʌlz.'fɔː.pɔɪnt.'sɪk.spɔɪnt.'zeɪ.ʌ.ɹəʊ
rsa	`ɑ.`ɹɛ.'seɪ
werkzeug	'wəːkz.jʉːɡ
wtforms	`dʌ.bʌl.`jʉː.'ti.'fɔːmz
re/port	`ɹi.'slæʃ.'pɔːt
travel's	'tɹæ.vʌl.'bæk.slæ.'ʃɛs
plods	'plɑdz
dully	'dʌ.lɪ
wretch	'ɹɛtʃ
wherefore	'wəː.fɔː
triptyne	'tɹɪp.taɪn
bride-offer	'bɹaɪ.'dɑ.fʌ
bridebeater	'bɹaɪd.bi.tʌ
tired—it's	'taɪ.ʌ.dɪt.'bæk.slæ.'ʃɛs
shouldest	'ʃʊə.dʌst
lebowski	lɛ.'bəʊ.skɪ
thatest	'θeɪ.tʌst
quiet"—until	'kwaɪ.ʌt.'bæk.slæ.ʃʌn.'tɪl
court-chamber	'kɔːt.'tʃeɪm.bʌ
it—oh	ɪ.'təʊ
wait—but	'weɪt.`bʌt
well-doing	'wɛl.'dʉː.ɪŋ
bridecarl	'bɹaɪd.kɑl
canst	'kænst
loveest	'lʌ.vʌst
bidding."<|endoftext|><|endoftext|><|endoftext|><|endoftext|><|endoftext|><|endoftext|><|endoftext|><|endoftext|><|endoftext|><|endoftext|><|endoftext|><|endoftext|><|endoftext|><|endoftext	'bɪ.dɪŋ.'dɑt.bʌk.`slæ.'ʃɛn.dəʊf.`tɛk.'stɛn.dəʊf.`tɛk.'stɛn.dəʊf.`tɛk.'stɛn.dəʊf.`tɛk.'stɛn.dəʊf.`tɛk.'stɛn.dəʊf.`tɛk.'stɛn.dəʊf.`tɛk.'stɛn.dəʊf.`tɛk.'stɛn.dəʊf.`tɛk.'stɛn.dəʊf.`tɛk.'stɛn.dəʊf.`tɛk.'stɛn.dəʊf.`tɛk.'stɛn.dəʊf.`tɛk.'stɛn.dəʊf.`tɛkst
marriageable	'mæ.ɹɪ.dʒʌ.bʌl
romean	ɹəʊ.'meɪ.ʌn
bride-to-be	'bɹaɪd.tʌ.'bi
bride-price	'bɹaɪd.'pɹaɪs
black-man	'blæk.'mæn
maisle	'meɪ.sʌl
sanctified	'sænk.tɪ.`faɪd
partaker	'pɑ.teɪ.kʌ
mayest	'meɪ.ʌst
gladness	'ɡlæd.nʌs
suffering.<|endoftext|><|endoftext|><|endoftext|><|endoftext|><|endoftext|><|endoftext|><|endoftext|><|endoftext|><|endoftext|><|endoftext|><|endoftext|><|endoftext|><|endoftext	'sʌ.fʌ.ɹɪŋ.'ɛn.dəʊf.`tɛk.'stɛn.dəʊf.`tɛk.'stɛn.dəʊf.`tɛk.'stɛn.dəʊf.`tɛk.'stɛn.dəʊf.`tɛk.'stɛn.dəʊf.`tɛk.'stɛn.dəʊf.`tɛk.'stɛn.dəʊf.`tɛk.'stɛn.dəʊf.`tɛk.'stɛn.dəʊf.`tɛk.'stɛn.dəʊf.`tɛk.'stɛn.dəʊf.`tɛk.'stɛn.dəʊf.`tɛkst
family-folk	'fæ.mɪ.lɪ.'fəʊk
o.c	`əʊ.'si
hadst	'hædst
you—the	jʉː.'ðʌ
ii	`ɹəʊ.mʌn.'tʉː
10	'tɛn
4	'fɔː
lived--trying	'lɪvd.'tɹaɪ.ɪŋ
pg	`pi.'dʒi
bottle--and	'bɑ.tʌ.lænd
22:30	'twɛn.tɪ.'tʉː.'θəː.tɪ
2	'tʉː
41	'fɔː.tɪ.'wɑn
2)--for	'tʉː.fɔː
saith	'seɪθ
it."<|endoftext|><|endoftext|><|endoftext|><|endoftext|><|endoftext|><|endoftext|><|endoftext|><|endoftext|><|endoftext|><|endoftext|><|endoftext|><|endoftext|><|endoftext	ɪt.'dɑt.bʌk.`slæ.'ʃɛn.dəʊf.`tɛk.'stɛn.dəʊf.`tɛk.'stɛn.dəʊf.`tɛk.'stɛn.dəʊf.`tɛk.'stɛn.dəʊf.`tɛk.'stɛn.dəʊf.`tɛk.'stɛn.dəʊf.`tɛk.'stɛn.dəʊf.`tɛk.'stɛn.dəʊf.`tɛk.'stɛn.dəʊf.`tɛk.'stɛn.dəʊf.`tɛk.'stɛn.dəʊf.`tɛk.'stɛn.dəʊf.`tɛkst
pleasantest	'plɛ.zæn.tʌst
22	'twɛn.tɪ.'tʉː
neighbour	'neɪ.bʌ
looketh	'lʊə.kʌθ
you...i'm	'jʉː.aɪ.'bæk.slæ.'ʃɛm
couldn�t	'kʊə.dʌn.'ti
hogwarts	'hɑ.ɡwɔːts
out...i	'aʊ.'taɪ
dark-tansword	'dɑk.'tæn.sɔːd
endoftext|><|endoftext|><|endoftext|><|endoftext|><|endoftext|><|endoftext|><|endoftext|><|endoftext|><|endoftext|><|endoftext	'ɛn.dəʊf.`tɛk.'stɛn.dəʊf.`tɛk.'stɛn.dəʊf.`tɛk.'stɛn.dəʊf.`tɛk.'stɛn.dəʊf.`tɛk.'stɛn.dəʊf.`tɛk.'stɛn.dəʊf.`tɛk.'stɛn.dəʊf.`tɛk.'stɛn.dəʊf.`tɛk.'stɛn.dəʊf.`tɛkst
endoftext|><|endoftext|><|endoftext|><|endoftext|><|endoftext|><|endoftext|><|endoftext|><|endoftext|><|endoftext|><|endoftext|><|endoftext|><|endoftext|><|endoftext|><|endoftext|><|endoftext|><|endoftext|><|endoftext|><|endoftext|><|endoftext	'ɛn.dəʊf.`tɛk.'stɛn.dəʊf.`tɛk.'stɛn.dəʊf.`tɛk.'stɛn.dəʊf.`tɛk.'stɛn.dəʊf.`tɛk.'stɛn.dəʊf.`tɛk.'stɛn.dəʊf.`tɛk.'stɛn.dəʊf.`tɛk.'stɛn.dəʊf.`tɛk.'stɛn.dəʊf.`tɛk.'stɛn.dəʊf.`tɛk.'stɛn.dəʊf.`tɛk.'stɛn.dəʊf.`tɛk.'stɛn.dəʊf.`tɛk.'stɛn.dəʊf.`tɛk.'stɛn.dəʊf.`tɛk.'stɛn.dəʊf.`tɛk.'stɛn.dəʊf.`tɛk.'stɛn.dəʊf.`tɛkst
donít	'dɑ.nɪt
wot	'wɑt
unknow	ʌn.'nəʊ
corinthians	kʌ.'ɹɪn.θeɪ.ʌnz
esv	'ɛsv
1	'wɑn
7:23-25	'sɛ.vʌn.'twɛn.tɪ.'θɹi.'dæʃ.'twɛn.tɪ.'faɪv
5	'faɪv
eph	'ɛf
2:17	'tʉː.'sɛ.vʌn.`tin
33	'θəː.tɪ.'θɹi
16	'sɪk.stin
kjv	`keɪ.`dʒeɪ.'vi
nephi	'nɛ.faɪ
2:6	'tʉː.'kəʊ.lʌn.'sɪks
9	'naɪn
change!<|endoftext|><|endoftext|><|endoftext|><|endoftext|><|endoftext|><|endoftext|><|endoftext|><|endoftext|><|endoftext|><|endoftext|><|endoftext|><|endoftext|><|endoftext|><|endoftext|><|endoftext|><|endoftext	'tʃeɪn.'dʒɛn.dəʊf.`tɛk.'stɛn.dəʊf.`tɛk.'stɛn.dəʊf.`tɛk.'stɛn.dəʊf.`tɛk.'stɛn.dəʊf.`tɛk.'stɛn.dəʊf.`tɛk.'stɛn.dəʊf.`tɛk.'stɛn.dəʊf.`tɛk.'stɛn.dəʊf.`tɛk.'stɛn.dəʊf.`tɛk.'stɛn.dəʊf.`tɛk.'stɛn.dəʊf.`tɛk.'stɛn.dəʊf.`tɛk.'stɛn.dəʊf.`tɛk.'stɛn.dəʊf.`tɛk.'stɛn.dəʊf.`tɛkst
6	'sɪks
god-sent	'ɡɑd.'sɛnt
leviticus	lɛ.'vɪ.tɪ.kʌs
20:4	'twɛn.tɪ.'kəʊ.lʌn.'fɔː
6:22-25	'sɪks.'twɛn.tɪ.'tʉː.'dæʃ.'twɛn.tɪ.'faɪv
dwelleth	'dwɛ.lʌθ
32.17	'θəː.tɪ.'tʉː.pɔɪn.'twɑn.'sɛ.vʌn
17:28-29	'sɛ.vʌn.`tin.'twɛn.tɪ.'eɪt.'dæʃ.'twɛn.tɪ.'naɪn
allaah	'æ.lɑ
open-minded	'əʊ.pʌn.'maɪn.dɪd
heareth	'heɪ.ʌ.ɹʌθ
3	'θɹi
יקו	`jdkfvæv
עובה	'æ.jɪn.`vævbth
ס	'sæmk
man-servant	'mæn.'səː.vʌnt
pharisees	'fæ.ɹɪ.`siz
leviticum	'lɛ.vɪ.`tɪ.kʌm
20,1-15	'twɛn.tɪ.'wɑn.'dæʃ.'fɪf.tin
redeemer	ɹɪ.'di.mʌ
53:22	'fɪf.tɪ.'θɹi.'twɛn.tɪ.'tʉː
14:22	'fɔː.tin.'twɛn.tɪ.'tʉː
24	'twɛn.tɪ.'fɔː
beest	'bist
meekness	'mik.nʌs
faithfulness	'feɪθ.fʌl.nʌs
amest	'eɪ.mʌst
24:13	'twɛn.tɪ.'fɔː.'θəː.tin
14:8	'fɔː.tin.'kəʊ.lʌ.'neɪt
levitican	'lɛ.vɪ.`tɪ.kʌn
20.2-4	'twɛn.tɪ.pɔɪnt.'tʉː.'dæʃ.'fɔː
8:6	'eɪt.'kəʊ.lʌn.'sɪks
3:9-11	'θɹi.'kəʊ.lʌn.'naɪn.'dæ.ʃɪ.'lɛ.vʌn
25:34-37	'twɛn.tɪ.'faɪv.'θəː.tɪ.'fɔː.'dæʃ.'θəː.tɪ.'sɛ.vʌn
handmaidens	'hænd.meɪ.dʌnz
thyself	θaɪ.'sɛlf
thirty-seven	'θəː.tɪ.'sɛ.vʌn
to-day	tʌ.'deɪ
dizzy.<|endoftext|><|endoftext|><|endoftext|><|endoftext|><|endoftext|><|endoftext|><|endoftext|><|endoftext|><|endoftext|><|endoftext|><|endoftext	'dɪ.zɪ.'ɛn.dəʊf.`tɛk.'stɛn.dəʊf.`tɛk.'stɛn.dəʊf.`tɛk.'stɛn.dəʊf.`tɛk.'stɛn.dəʊf.`tɛk.'stɛn.dəʊf.`tɛk.'stɛn.dəʊf.`tɛk.'stɛn.dəʊf.`tɛk.'stɛn.dəʊf.`tɛk.'stɛn.dəʊf.`tɛk.'stɛn.dəʊf.`tɛkst
d.'b	'di.'dɑt.bʌk.`slæʃ.'bi
s.w/i.f	`ɛs.'dʌ.bʌl.`jʉː.'slæ.`ʃaɪ.'ɛf
couldn	'kʊə.dʌn
zechariah	`zɛ.tʃɑ.'ɹaɪ.ʌ
8th	'eɪtθ
9:17	'naɪn.'sɛ.vʌn.`tin
deuteronomy	`djʉː.tʌ.'ɹɑ.nʌ.mɪ
21:20	'twɛn.tɪ.'wɑn.'twɛn.tɪ
pharisee	'fæ.ɹɪ.`si
sinfulness	'sɪn.fʌl.nʌs
unbreakable	ʌn.'bɹeɪ.kʌ.bʌl
self-expression	'sɛl.fɛk.'spɹɛ.ʃʌn
seest	'sist
ll	`ɛ.'lɛl
destiny's	'dɛ.stɪ.nɪ.'bæk.slæ.'ʃɛs
handmaid	'hænd.meɪd
first-mentioned	'fəːst.'mɛn.ʃʌnd
don'sn't	'dɑn.'bæk.slæ.`ʃɛ.'sɛn.'bæk.slæʃ.'ti
10:14	'tɛn.'fɔː.tin
face-wrenching	'feɪs.'ɹɛn.tʃɪŋ
well-being	'wɛl.'bi.ɪŋ
wherewith	wəː.'wɪð
jer	'dʒəː
wast	'wɑst
ezekiel's	'ɛ.zɪ.`kil.'bæk.slæ.'ʃɛs
ahem	ʌ.'hʌm
soul's	'səʊl.'bæk.slæ.'ʃɛs
19:22	'naɪn.tin.'twɛn.tɪ.'tʉː
1858	'wɑn.'θaʊ.zʌn.'deɪt.'hʌn.dɹʌ.dʌn.'fɪf.tɪ.'eɪt
15:18	'fɪf.ti.'neɪ.tin
this--at	ðɪ.'sæt
lev:23-29	'lɛv.'kəʊ.lʌn.'twɛn.tɪ.'θɹi.'dæʃ.'twɛn.tɪ.'naɪn
askest	'æ.skʌst
t.e	`ti.'i
prophesy	'pɹɑ.fʌ.sɪ
earth...i	'əː.'θaɪ
kahlili<|endoftext|><|endoftext|><|endoftext|><|endoftext|><|endoftext|><|endoftext|><|endoftext|><|endoftext|><|endoftext	'kɑ.lɪ.`lɪ.'ɛn.dəʊf.`tɛk.'stɛn.dəʊf.`tɛk.'stɛn.dəʊf.`tɛk.'stɛn.dəʊf.`tɛk.'stɛn.dəʊf.`tɛk.'stɛn.dəʊf.`tɛk.'stɛn.dəʊf.`tɛk.'stɛn.dəʊf.`tɛk.'stɛn.dəʊf.`tɛkst
verily	'vɛ.ɹɪ.lɪ
zephaniah	zɛ.'feɪ.'naɪ.ʌ
aught	'ɔːt
this—especially	ðɪ.sɪ.'spɛ.ʃʌ.`lɪ
brother-in-law	'bɹʌ.ðʌ.ɹɪn.'lɔː
earth-to-be	'əːθ.tʌ.'bi
zarahemla	'zæ.ɹʌ.`hɛm.lʌ
4:26	'fɔː.'twɛn.tɪ.'sɪks
7	'sɛ.vʌn
8	'eɪt
ye've	ji.'bæk.slæʃ.'vi
forelaid	'fɔː.leɪd
hand."7	'hænd.'dɑt.bʌk.`slæʃ.'sɛ.vʌn
seekest	'si.kʌst
lieth	'laɪ.ʌθ
knowest	'nəʊ.ʌst
shat	'ʃæt
mustst	'mʌstst
12	'twɛlv
god—and	'ɡɑ.dænd
2:1	'tʉː.'kəʊ.lʌn.'wɑn
19	'naɪn.tin
2015	'tʉː.'θaʊ.zʌn.dʌn.'fɪf.tin
100	'wɑn.'hʌn.dɹʌd
don`t	'dɑn.'ti
16:19	'sɪk.stin.'naɪn.tin
sayest	'seɪ.ʌst
we'd've	wi.'bæk.slæʃ.'di.'bæk.slæʃ.'vi
maddows	'mæ.dəʊz
49:1	'fɔː.tɪ.'naɪn.'kəʊ.lʌn.'wɑn
wouldst	'wʊədst
3:1,18	'θɹi.'kəʊ.lʌn.'wɑ.'neɪ.tin
knowe	'nəʊ
speakest	'spi.kʌst
thee—and	'ði.ænd
one-eye	'wɑ.'naɪ
p.p.'s	'pi.'dɑt.'pi.'dɑt.bʌk.`slæ.'ʃɛs
didst	'dɪdst
nought	'nɔːt
one-two	'wɑn.'tʉː
seeth	'siθ
loveth	'lʌ.vʌθ
only-begotten	'əʊn.lɪ.bɪ.'ɡɑ.tʌn
knowth	'nəʊθ
sele	'sil
endoftext|><|endoftext|><|endoftext|><|endoftext|><|endoftext	'ɛn.dəʊf.`tɛk.'stɛn.dəʊf.`tɛk.'stɛn.dəʊf.`tɛk.'stɛn.dəʊf.`tɛk.'stɛn.dəʊf.`tɛkst
worde	'wəːd
tathagata'u	`tæ.θʌ.'ɡɑ.tʌ.'bæk.slæʃ.'jʉː
doest	'dəʊst
holdeth	'həʊl.dʌθ
thou'sse	'ðaʊ.'bæk.slæ.`ʃɛ.`sɛ.'si
17	'sɛ.vʌn.`tin
seeketh	'si.kʌθ
speakin	'spi.kɪn
thither	'ðɪ.ðʌ
20	'twɛn.tɪ
imperate	ɪm.'pəː.ɹʌt
effulgence	ɪ.'fʌl.dʒʌns
1812	'wɑn.'θaʊ.zʌn.'deɪt.'hʌn.dɹʌ.dʌn.'twɛlv
1712	'wɑn.'θaʊ.zʌnd.'sɛ.vʌn.'hʌn.dɹʌ.dʌn.'twɛlv
grav	'ɡɹæv
desirest	dɪ.'zaɪ.ʌ.ɹʌst
thord	'θɔːd
thines	'ðaɪnz
22)--in	'twɛn.tɪ.'tʉː.'ɪn
tribitors	'tɹaɪ.bɪ.tʌz
friendless	'fɹɛnd.lʌs
25	'twɛn.tɪ.'faɪv
wouldest	'wʊə.dʌst
15	'fɪf.tin
mightest	'maɪ.tʌst
willest	'wɪ.lʌst
15:16-18	'fɪf.tin.'sɪk.stin.'dæ.'ʃeɪ.tin
iniquity	ɪ.'nɪ.kwɪ.tɪ
couldest	'kʊə.dʌst
1375	'wɑn.'θaʊ.zʌnd.'θɹi.'hʌn.dɹʌ.dʌn.'sɛ.vʌn.tɪ.'faɪv
loveliness	'lʌv.lɪ.nʌs
mayst	'meɪst
calling—that	'kɔː.lɪŋ.'ðæt
space—with	'speɪ.swɪð
hiltaye	'hɪl.teɪ
483-486	'fɔː.'hʌn.dɹʌ.dʌ.'neɪ.tɪ.'θɹi.'dæʃ.'fɔː.'hʌn.dɹʌ.dʌ.'neɪ.tɪ.'sɪks
dressor	'dɹɛ.sʌ
godliness	'ɡɑd.lɪ.nʌs
god-given	'ɡɑd.'ɡɪ.vʌn
us—and	'ʌ.sænd
god...the	'ɡɑd.'ðʌ
wieldeth	'wil.dʌθ
1:19"the	'wɑn.'naɪn.tin.'bæk.slæʃ.ðʌ
ezek	'ɛ.zɛk
d&c	'di.ænd.'si
88:1	'eɪ.tɪ.'eɪt.'kəʊ.lʌn.'wɑn
1:9-13	'wɑn.'kəʊ.lʌn.'naɪn.'dæʃ.'θəː.tin
a.d	`eɪ.'di
120	'wɑn.'hʌn.dɹʌ.dʌn.'twɛn.tɪ
3:22	'θɹi.'twɛn.tɪ.'tʉː
4:25	'fɔː.'twɛn.tɪ.'faɪv
i.e	'aɪ.i
quoth	'kwɑθ
now—be	'naʊ.'bi
god.<|endoftext|><|endoftext|><|endoftext|><|endoftext|><|endoftext|><|endoftext|><|endoftext|><|endoftext|><|endoftext	'ɡɑ.'dɛn.dəʊf.`tɛk.'stɛn.dəʊf.`tɛk.'stɛn.dəʊf.`tɛk.'stɛn.dəʊf.`tɛk.'stɛn.dəʊf.`tɛk.'stɛn.dəʊf.`tɛk.'stɛn.dəʊf.`tɛk.'stɛn.dəʊf.`tɛk.'stɛn.dəʊf.`tɛkst
13	'θəː.tin
andof	'æn.dɑf
great-grandchild	'ɡɹeɪt.'ɡɹænd.tʃaɪld
11:15	ɪ.'lɛ.vʌn.'fɪf.tin
hebrews	'hi.bɹʉːz
handmaiden	'hænd.meɪ.dʌn
light-stair	'laɪt.'stəː
tiberius	taɪ.'beɪ.ʌ.ɹɪ.ʌs
siloath	'saɪ.ləʊθ
i-us	aɪ.'ʌs
a-mazda	'eɪ.'mæz.dʌ
sunbeams	'sʌn.bimz
749	'sɛ.vʌn.'hʌn.dɹʌ.dʌn.'fɔː.tɪ.'naɪn
1846-2007	'wɑn.'θaʊ.zʌn.'deɪt.'hʌn.dɹʌ.dʌn.'fɔː.tɪ.'sɪks.'dæʃ.'tʉː.'θaʊ.zʌn.dʌn.'sɛ.vʌn
29	'twɛn.tɪ.'naɪn
34	'θəː.tɪ.'fɔː
2007	'tʉː.'θaʊ.zʌn.dʌn.'sɛ.vʌn
53	'fɪf.tɪ.'θɹi
514	'faɪv.'hʌn.dɹʌ.dʌn.'fɔː.tin
signs.<|endoftext|><|endoftext|><|endoftext|><|endoftext|><|endoftext|><|endoftext|><|endoftext|><|endoftext|><|endoftext|><|endoftext|><|endoftext|><|endoftext|><|endoftext|><|endoftext|><|endoftext|><|endoftext|><|endoftext	'saɪn.'zɛn.dəʊf.`tɛk.'stɛn.dəʊf.`tɛk.'stɛn.dəʊf.`tɛk.'stɛn.dəʊf.`tɛk.'stɛn.dəʊf.`tɛk.'stɛn.dəʊf.`tɛk.'stɛn.dəʊf.`tɛk.'stɛn.dəʊf.`tɛk.'stɛn.dəʊf.`tɛk.'stɛn.dəʊf.`tɛk.'stɛn.dəʊf.`tɛk.'stɛn.dəʊf.`tɛk.'stɛn.dəʊf.`tɛk.'stɛn.dəʊf.`tɛk.'stɛn.dəʊf.`tɛk.'stɛn.dəʊf.`tɛk.'stɛn.dəʊf.`tɛkst
441	'fɔː.'hʌn.dɹʌ.dʌn.'fɔː.tɪ.'wɑn
wicked-hearted	'wɪ.kɪd.'hɑ.tɪd
see.<|endoftext|><|endoftext|><|endoftext|><|endoftext|><|endoftext|><|endoftext|><|endoftext|><|endoftext|><|endoftext|><|endoftext|><|endoftext|><|endoftext|><|endoftext|><|endoftext|><|endoftext|><|endoftext	'si.'ɛn.dəʊf.`tɛk.'stɛn.dəʊf.`tɛk.'stɛn.dəʊf.`tɛk.'stɛn.dəʊf.`tɛk.'stɛn.dəʊf.`tɛk.'stɛn.dəʊf.`tɛk.'stɛn.dəʊf.`tɛk.'stɛn.dəʊf.`tɛk.'stɛn.dəʊf.`tɛk.'stɛn.dəʊf.`tɛk.'stɛn.dəʊf.`tɛk.'stɛn.dəʊf.`tɛk.'stɛn.dəʊf.`tɛk.'stɛn.dəʊf.`tɛk.'stɛn.dəʊf.`tɛk.'stɛn.dəʊf.`tɛkst
come—and	'kʌ.mænd
dumbledore	'dʌ.mʌl.`dɔː
more…]<|endoftext|><|endoftext|><|endoftext|><|endoftext|><|endoftext|><|endoftext|><|endoftext|><|endoftext|><|endoftext|><|endoftext|><|endoftext|><|endoftext|><|endoftext|><|endoftext|><|endoftext|><|endoftext|><|endoftext|><|endoftext	'mɔː.'ɛn.dəʊf.`tɛk.'stɛn.dəʊf.`tɛk.'stɛn.dəʊf.`tɛk.'stɛn.dəʊf.`tɛk.'stɛn.dəʊf.`tɛk.'stɛn.dəʊf.`tɛk.'stɛn.dəʊf.`tɛk.'stɛn.dəʊf.`tɛk.'stɛn.dəʊf.`tɛk.'stɛn.dəʊf.`tɛk.'stɛn.dəʊf.`tɛk.'stɛn.dəʊf.`tɛk.'stɛn.dəʊf.`tɛk.'stɛn.dəʊf.`tɛk.'stɛn.dəʊf.`tɛk.'stɛn.dəʊf.`tɛk.'stɛn.dəʊf.`tɛk.'stɛn.dəʊf.`tɛkst
more...]<|endoftext|><|endoftext|><|endoftext|><|endoftext|><|endoftext|><|endoftext|><|endoftext|><|endoftext|><|endoftext|><|endoftext|><|endoftext|><|endoftext|><|endoftext|><|endoftext|><|endoftext|><|endoftext|><|endoftext|><|endoftext	'mɔː.'ɛn.dəʊf.`tɛk.'stɛn.dəʊf.`tɛk.'stɛn.dəʊf.`tɛk.'stɛn.dəʊf.`tɛk.'stɛn.dəʊf.`tɛk.'stɛn.dəʊf.`tɛk.'stɛn.dəʊf.`tɛk.'stɛn.dəʊf.`tɛk.'stɛn.dəʊf.`tɛk.'stɛn.dəʊf.`tɛk.'stɛn.dəʊf.`tɛk.'stɛn.dəʊf.`tɛk.'stɛn.dəʊf.`tɛk.'stɛn.dəʊf.`tɛk.'stɛn.dəʊf.`tɛk.'stɛn.dəʊf.`tɛk.'stɛn.dəʊf.`tɛk.'stɛn.dəʊf.`tɛkst
wizarding	'wɪ.zʌ.dɪŋ
ii:13	`ɹəʊ.mʌn.'tʉː.'kəʊ.lʌn.'θəː.tin
partaken	'pɑ.teɪ.kʌn
belieth	bɪ.'leɪ.ʌθ
here.<|endoftext	'heɪ.ʌ.'ɛn.dəʊf.`tɛkst
couldst	'kʊədst
mightst	'maɪtst
instence	ɪn.'stɛns
golden-hued	'ɡəʊl.dʌn.'hjʉːd
wonted	'wɑn.tɪd
weep—you	'wi.pjʉː
you?"--"the	jʉː.'bæk.slæʃ.'bæk.slæʃ.ðʌ
cuthberts	'kʌθ.bʌts
1749	'wɑn.'θaʊ.zʌnd.'sɛ.vʌn.'hʌn.dɹʌ.dʌn.'fɔː.tɪ.'naɪn
thess	'θɛs
first-born	'fəːst.'bɔːn
daoism	'daʊ.ɪ.zʌm
102:19	'wɑn.'hʌn.dɹʌ.dʌn.'tʉː.'naɪn.tin
dagon's	'dæ.ɡɑn.'bæk.slæ.'ʃɛs
d.a.m.'s	`di.'eɪ.'ɛm.'dɑt.bʌk.`slæ.'ʃɛs
romana	ɹəʊ.'mɑ.nʌ
arjeine	'ɑ.dʒin
1:6	'wɑn.'kəʊ.lʌn.'sɪks
endoftext|><|endoftext|><|endoftext|><|endoftext|><|endoftext|><|endoftext|><|endoftext|><|endoftext|><|endoftext|><|endoftext|><|endoftext|><|endoftext|><|endoftext|><|endoftext|><|endoftext|><|endoftext|><|endoftext|><|endoftext|><|endoftext|><|endoftext	'ɛn.dəʊf.`tɛk.'stɛn.dəʊf.`tɛk.'stɛn.dəʊf.`tɛk.'stɛn.dəʊf.`tɛk.'stɛn.dəʊf.`tɛk.'stɛn.dəʊf.`tɛk.'stɛn.dəʊf.`tɛk.'stɛn.dəʊf.`tɛk.'stɛn.dəʊf.`tɛk.'stɛn.dəʊf.`tɛk.'stɛn.dəʊf.`tɛk.'stɛn.dəʊf.`tɛk.'stɛn.dəʊf.`tɛk.'stɛn.dəʊf.`tɛk.'stɛn.dəʊf.`tɛk.'stɛn.dəʊf.`tɛk.'stɛn.dəʊf.`tɛk.'stɛn.dəʊf.`tɛk.'stɛn.dəʊf.`tɛk.'stɛn.dəʊf.`tɛkst
viii	`ɹəʊ.mʌ.'neɪt
1845-1930	'wɑn.'θaʊ.zʌn.'deɪt.'hʌn.dɹʌ.dʌn.'fɔː.tɪ.'faɪv.'dæʃ.'naɪn.tin.'hʌn.dɹʌ.dʌn.'θəː.tɪ
xiv	`ɹəʊ.mʌn.'fɔː.tin
3:11	'θɹi.ɪ.'lɛ.vʌn
12:16	'twɛlv.'sɪk.stin
32	'θəː.tɪ.'tʉː
s/p	'ɛs.'slæʃ.'pi
s&v1	'ɛ.sænd.'vi.'wɑn
endoftext|><|endoftext|><|endoftext|><|endoftext|><|endoftext|><|endoftext|><|endoftext|><|endoftext|><|endoftext|><|endoftext|><|endoftext|><|endoftext|><|endoftext|><|endoftext	'ɛn.dəʊf.`tɛk.'stɛn.dəʊf.`tɛk.'stɛn.dəʊf.`tɛk.'stɛn.dəʊf.`tɛk.'stɛn.dəʊf.`tɛk.'stɛn.dəʊf.`tɛk.'stɛn.dəʊf.`tɛk.'stɛn.dəʊf.`tɛk.'stɛn.dəʊf.`tɛk.'stɛn.dəʊf.`tɛk.'stɛn.dəʊf.`tɛk.'stɛn.dəʊf.`tɛk.'stɛn.dəʊf.`tɛk.'stɛn.dəʊf.`tɛkst
11	ɪ.'lɛ.vʌn
1:5	'wɑn.'kəʊ.lʌn.'faɪv
beheld	bɪ.'hɛld
46:30	'fɔː.tɪ.'sɪks.'θəː.tɪ
matthew18:36	'mæ.θjʉː.'eɪ.tin.'θəː.tɪ.'sɪks
2:29	'tʉː.'twɛn.tɪ.'naɪn
3:36	'θɹi.'θəː.tɪ.'sɪks
walkest	'wɔː.kʌst
3-14	'θɹi.'dæʃ.'fɔː.tin
beseech	bɪ.'sitʃ
7and	'sɛ.vʌ.nænd
jn	`dʒeɪ.'ɛn
15:3	'fɪf.tin.'kəʊ.lʌn.'θɹi
goeth	'ɡəʊ.ʌθ
niv	'nɪv
beareth	'bəː.ɹʌθ
shouldst	'ʃʊədst
139:14	'wɑn.'hʌn.dɹʌ.dʌn.'θəː.tɪ.'naɪn.'fɔː.tin
endoftext|><|endoftext|><|endoftext|><|endoftext|><|endoftext|><|endoftext|><|endoftext|><|endoftext|><|endoftext	'ɛn.dəʊf.`tɛk.'stɛn.dəʊf.`tɛk.'stɛn.dəʊf.`tɛk.'stɛn.dəʊf.`tɛk.'stɛn.dəʊf.`tɛk.'stɛn.dəʊf.`tɛk.'stɛn.dəʊf.`tɛk.'stɛn.dəʊf.`tɛk.'stɛn.dəʊf.`tɛkst
thee.'—abraham	`ði.'dɑt.bʌk.`slæ.'ʃeɪ.bɹʌ.`hæm
meso	'mi.səʊ
s.v	`ɛs.'vi
way--for	'weɪ.fɔː
rouses	'ɹaʊ.zɪz
seeest	'si.ʌst
comest	kʌ.'mɛst
faireth	'fəːθ
kindliness	'kaɪnd.lɪ.nʌs
them."<|endoftext|><|endoftext|><|endoftext|><|endoftext|><|endoftext|><|endoftext|><|endoftext|><|endoftext|><|endoftext|><|endoftext	`ðɛm.'dɑt.bʌk.`slæ.'ʃɛn.dəʊf.`tɛk.'stɛn.dəʊf.`tɛk.'stɛn.dəʊf.`tɛk.'stɛn.dəʊf.`tɛk.'stɛn.dəʊf.`tɛk.'stɛn.dəʊf.`tɛk.'stɛn.dəʊf.`tɛk.'stɛn.dəʊf.`tɛk.'stɛn.dəʊf.`tɛk.'stɛn.dəʊf.`tɛkst
creator—we	kɹi.'eɪ.tʌ.wi
tentate	'tɛn.teɪt
wher	'wəː
soul-soul	'səʊl.'səʊl
god-forsaken	'ɡɑd.fɔː.'seɪ.kʌn
self-effacement	'sɛl.fɪ.'feɪ.smʌnt
wils	'wɪlz
full-bred	'fʊəl.'bɹɛd
twere	'tweɪ.ʌ
self-giving	'sɛlf.'ɡɪ.vɪŋ
kindeness	'kaɪnd.nʌs
faireest	'fəː.ɹʌst
lightless	'laɪt.lʌs
spirit-spiritual	'spɪ.ɹɪt.'spɪ.ɹɪ.`tʃʉː.ʌl
actions.<|endoftext|><|endoftext|><|endoftext|><|endoftext|><|endoftext|><|endoftext|><|endoftext|><|endoftext|><|endoftext	'æk.ʃʌn.'zɛn.dəʊf.`tɛk.'stɛn.dəʊf.`tɛk.'stɛn.dəʊf.`tɛk.'stɛn.dəʊf.`tɛk.'stɛn.dəʊf.`tɛk.'stɛn.dəʊf.`tɛk.'stɛn.dəʊf.`tɛk.'stɛn.dəʊf.`tɛk.'stɛn.dəʊf.`tɛkst
köln	'kəːləːn
all-consuming	'ɔːl.kʌn.'sʉː.mɪŋ
forever—one	fʌ.'ɹɛ.vʌ.`wɑn
gendarmol	'dʒɛn.dɑ.`mɑl
gendam	'dʒɛn.dʌm
3-5)--the	'θɹi.'dæʃ.'faɪv.ðʌ
9)--the	'naɪn.ðʌ
free.<|endoftext|><|endoftext|><|endoftext|><|endoftext|><|endoftext|><|endoftext|><|endoftext|><|endoftext|><|endoftext|><|endoftext|><|endoftext|><|endoftext|><|endoftext|><|endoftext	'fɹi.'ɛn.dəʊf.`tɛk.'stɛn.dəʊf.`tɛk.'stɛn.dəʊf.`tɛk.'stɛn.dəʊf.`tɛk.'stɛn.dəʊf.`tɛk.'stɛn.dəʊf.`tɛk.'stɛn.dəʊf.`tɛk.'stɛn.dəʊf.`tɛk.'stɛn.dəʊf.`tɛk.'stɛn.dəʊf.`tɛk.'stɛn.dəʊf.`tɛk.'stɛn.dəʊf.`tɛk.'stɛn.dəʊf.`tɛk.'stɛn.dəʊf.`tɛkst
28:6	'twɛn.tɪ.'eɪt.'kəʊ.lʌn.'sɪks
god-worshippers	'ɡɑ.'dwəː.ʃɪ.pʌz
h.b.h	`eɪtʃ.`bi.'eɪtʃ
18	'eɪ.tin
honour	'ɑ.nʌ
intelligence—to	ɪn.'tɛ.lɪ.dʒʌn.stʉː
lothar	'lɑ.θɑ
saying,—'come	'seɪ.ɪŋ.'bæk.slæʃ.'kʌm
say—but	'seɪ.`bʌt
the'savior	ðʌ.'bæk.slæʃ.'seɪ.vjʌ
lydians	'lɪ.deɪ.ʌnz
hard-hearted	'hɑd.'hɑ.tɪd
power—'the	'paʊ.ʌ.'bæk.slæʃ.ðʌ
practise	'pɹæk.tɪs
howbeit	'haʊ.beɪt
said—'they	'sɛd.'bæk.slæʃ.ðeɪ
worshipper	'wəː.ʃɪ.pʌ
20:29	'twɛn.tɪ.'twɛn.tɪ.'naɪn
meekley	'mi.klɪ
uttermost	'ʌ.tʌ.`məʊst
cf	`si.'ɛf
cantosaffilius	`kæn.tʌ.sʌ.'fɪ.lɪ.ʌs
peopler	'pi.plʌ
whisest	'waɪ.sʌst
praetorianism	'pɹi.tɔː.`ɹeɪ.ʌ.nɪ.zʌm
praetry	'pɹi.tɹɪ
deep-bred	'dip.'bɹɛd
purpose—a	'pəː.pʌ.'seɪ
gesbenezer	'dʒɛs.bʌ.`nɛ.zʌ
them.[25	'ðɛm.'twɛn.tɪ.'faɪv
caiaphas	'keɪ.æ.fʌz
sight-seeing	'saɪt.'si.ɪŋ
hewed	'hjʉːd
say—'if	'seɪ.'bæk.slæ.ʃɪf
etcetero	`ɛt.sɪ.'təː.ɹəʊ
sun-like	'sʌn.'laɪk
hobbits	'hɑ.bɪts
11:21	ɪ.'lɛ.vʌn.'twɛn.tɪ.'wɑn
hezekiah	`hɛ.zɪ.'kaɪ.ʌ
fear's	'feɪ.ʌ.'bæk.slæ.'ʃɛs
1:32	'wɑn.'θəː.tɪ.'tʉː
soulmate	'səʊl.meɪt
animal-foods	'æ.nɪ.mʌl.'fʉːdz
fairester	'fəː.stʌ
creature's	'kɹi.tʃʌ.'bæk.slæ.'ʃɛs
downton	'daʊn.tʌn
brexit	'bɹɛk.sɪt
exorbitantly	ɛɡ.'zɔː.bɪ.tʌnt.lɪ
overlaying	`əʊ.vʌ.'leɪ.ɪŋ
unknownly	ʌn.'nəʊn.lɪ
un-islamic	'ʌ.nɪ.'slɑ.mɪk
inanimals	ɪ.'næ.nɪ.mʌlz
gamergate	'ɡæ.mʌ.`ɡeɪt
liberationists	`lɪ.bʌ.'ɹeɪ.ʃʌ.`nɪsts
wayback	'weɪ.bæk
free-space	'fɹi.'speɪs
isbecause	'ɪs.bɪ.`kɔːz
ofthe	'ɑfð
nfl	`ɛ.`nɛ.'fɛl
dirtiness	'dəː.tɪ.nʌs
4.8	'fɔː.pɔɪn.'teɪt
form's	'fɔːm.'bæk.slæ.'ʃɛs
black-bearded	'blæk.'beɪ.ʌ.dɪd
sarvayn	'sɑ.veɪn
intergalactic	`ɪn.tʌ.ɡʌ.'læk.tɪk
guh	'ɡʌ
power...or	'paʊ.ʌ.'ɔː
sword.<|endoftext|><|endoftext|><|endoftext|><|endoftext|><|endoftext|><|endoftext|><|endoftext	'sɔː.'dɛn.dəʊf.`tɛk.'stɛn.dəʊf.`tɛk.'stɛn.dəʊf.`tɛk.'stɛn.dəʊf.`tɛk.'stɛn.dəʊf.`tɛk.'stɛn.dəʊf.`tɛk.'stɛn.dəʊf.`tɛkst
colour	'kʌ.lʌ
dead-world	'dɛ.'dwəːld
remains...they	ɹɪ.'meɪnz.'ðeɪ
human-like	'hjʉː.mʌn.'laɪk
thestereotypes	'ðɛ.stɪ.ɹɪ.`əʊ.taɪps
perished.<|endoftext|><|endoftext|><|endoftext|><|endoftext|><|endoftext|><|endoftext|><|endoftext|><|endoftext|><|endoftext|><|endoftext	'pɛ.ɹɪʃ.'tɛn.dəʊf.`tɛk.'stɛn.dəʊf.`tɛk.'stɛn.dəʊf.`tɛk.'stɛn.dəʊf.`tɛk.'stɛn.dəʊf.`tɛk.'stɛn.dəʊf.`tɛk.'stɛn.dəʊf.`tɛk.'stɛn.dəʊf.`tɛk.'stɛn.dəʊf.`tɛk.'stɛn.dəʊf.`tɛkst
i.d	`aɪ.'di
i.s.e.r	`aɪ.`ɛ.`si.'ɑ
now.<|endoftext|><|endoftext|><|endoftext|><|endoftext|><|endoftext|><|endoftext	'naʊ.'ɛn.dəʊf.`tɛk.'stɛn.dəʊf.`tɛk.'stɛn.dəʊf.`tɛk.'stɛn.dəʊf.`tɛk.'stɛn.dəʊf.`tɛk.'stɛn.dəʊf.`tɛkst
quiet.<|endoftext|><|endoftext|><|endoftext|><|endoftext|><|endoftext|><|endoftext|><|endoftext|><|endoftext|><|endoftext|><|endoftext|><|endoftext|><|endoftext|><|endoftext|><|endoftext|><|endoftext|><|endoftext|><|endoftext	'kwaɪ.ʌ.'tɛn.dəʊf.`tɛk.'stɛn.dəʊf.`tɛk.'stɛn.dəʊf.`tɛk.'stɛn.dəʊf.`tɛk.'stɛn.dəʊf.`tɛk.'stɛn.dəʊf.`tɛk.'stɛn.dəʊf.`tɛk.'stɛn.dəʊf.`tɛk.'stɛn.dəʊf.`tɛk.'stɛn.dəʊf.`tɛk.'stɛn.dəʊf.`tɛk.'stɛn.dəʊf.`tɛk.'stɛn.dəʊf.`tɛk.'stɛn.dəʊf.`tɛk.'stɛn.dəʊf.`tɛk.'stɛn.dəʊf.`tɛk.'stɛn.dəʊf.`tɛkst
50	'fɪf.tɪ
endoftext|><|endoftext|><|endoftext|><|endoftext|><|endoftext|><|endoftext|><|endoftext|><|endoftext|><|endoftext|><|endoftext|><|endoftext|><|endoftext|><|endoftext	'ɛn.dəʊf.`tɛk.'stɛn.dəʊf.`tɛk.'stɛn.dəʊf.`tɛk.'stɛn.dəʊf.`tɛk.'stɛn.dəʊf.`tɛk.'stɛn.dəʊf.`tɛk.'stɛn.dəʊf.`tɛk.'stɛn.dəʊf.`tɛk.'stɛn.dəʊf.`tɛk.'stɛn.dəʊf.`tɛk.'stɛn.dəʊf.`tɛk.'stɛn.dəʊf.`tɛk.'stɛn.dəʊf.`tɛkst
endoftext|><|endoftext|><|endoftext|><|endoftext|><|endoftext|><|endoftext|><|endoftext	'ɛn.dəʊf.`tɛk.'stɛn.dəʊf.`tɛk.'stɛn.dəʊf.`tɛk.'stɛn.dəʊf.`tɛk.'stɛn.dəʊf.`tɛk.'stɛn.dəʊf.`tɛk.'stɛn.dəʊf.`tɛkst
red-robed	'ɹɛ.'dɹəʊbd
all."<|endoftext|><|endoftext|><|endoftext|><|endoftext|><|endoftext|><|endoftext|><|endoftext|><|endoftext|><|endoftext|><|endoftext|><|endoftext|><|endoftext|><|endoftext|><|endoftext	'ɔːl.'dɑt.bʌk.`slæ.'ʃɛn.dəʊf.`tɛk.'stɛn.dəʊf.`tɛk.'stɛn.dəʊf.`tɛk.'stɛn.dəʊf.`tɛk.'stɛn.dəʊf.`tɛk.'stɛn.dəʊf.`tɛk.'stɛn.dəʊf.`tɛk.'stɛn.dəʊf.`tɛk.'stɛn.dəʊf.`tɛk.'stɛn.dəʊf.`tɛk.'stɛn.dəʊf.`tɛk.'stɛn.dəʊf.`tɛk.'stɛn.dəʊf.`tɛk.'stɛn.dəʊf.`tɛkst
5)--so	'faɪv.'səʊ
pp	`pi.'pi
ought—and	'ɔː.tænd
realise	'ɹeɪ.ʌ.laɪz
fellow-creatures	'fɛ.ləʊ.'kɹi.tʃʌz
beast's	'bist.'bæk.slæ.'ʃɛs
fearlessness	'feɪ.ʌ.lʌ.snʌs
battleaxe	'bæ.tʌ.`læks
far-away	'fɑ.ɹʌ.'weɪ
52]the	'fɪf.tɪ.'tʉː.ðʌ
comed	'kʌmd
diamond-haunted	'daɪ.ʌ.mʌnd.'hɔːn.tɪd
unbelievers	ʌn.bɪ.'li.vʌz
untenured	ʌn.'tɛn.jʌd
peltoni	pɛl.'təʊ.nɪ
semicontological	`sɛ.mɪ.kɑn.tʌ.'lɑ.dʒɪ.kʌl
well-equipped	'wɛ.lɪ.'kwɪpt
wagels	'weɪ.dʒʌlz
well-versed	'wɛl.'vəːsd
honourable	'ɑ.nʌ.ɹʌ.bʌl
piazzi	'paɪ.ʌ.`zɪ
jedi	'dʒɛ.daɪ
odo	'əʊ.dəʊ
osu	'ɑ.sʉː
soft-hearted	'sɑft.'hɑ.tɪd
hoodie	'hʊə.dɪ
zekkad	'zɛ.kæd
18-year-old	'eɪ.tin.'jeɪ.ʌ.'ɹəʊld
aunt-of-four	'æn.tɑv.'fɔː
sister-daughter-in-law	'sɪ.stʌ.'dɔː.tʌ.ɹɪn.'lɔː
mid-twenties	'mɪd.'twɛn.tɪz
o-ocho	'əʊ.'ɑ.tʃəʊ
heiress's	'əː.ɹɛs.'bæk.slæ.'ʃɛs
jek'sha	'dʒɛk.'bæk.slæʃ.'ʃɑ
tortuga	tɔː.'tʉː.ɡʌ
ewanda	jʉː.'æn.dʌ
omecha	'əʊm.tʃʌ
mokt.m	'mɑkt.'dɑ.'tɛm
koyasu	kɔɪ.'ɑ.sʉː
gavrilo	ɡæv.'ɹɪ.ləʊ
nuri	'njʊə.ɹɪ
self-sacrifice	'sɛlf.'sæ.kɹɪ.`faɪs
a.m	`eɪ.'ɛm
oso	'əʊ.səʊ
eighteen-seven	eɪ.'tin.'sɛ.vʌn
sia	'zeɪ.ʌ
tofir	'tɑ.feɪ.ʌ
jadon	'dʒæ.dɑn
22.8	'twɛn.tɪ.'tʉː.pɔɪn.'teɪt
exorcisms	'ɛk.sʌ.`sɪ.zʌmz
favour	'feɪ.vʌ
ayleid	'eɪ.ʌ.`lɪd
men.<|endoftext|><|endoftext|><|endoftext|><|endoftext|><|endoftext|><|endoftext|><|endoftext|><|endoftext|><|endoftext|><|endoftext|><|endoftext	'mɛ.'nɛn.dəʊf.`tɛk.'stɛn.dəʊf.`tɛk.'stɛn.dəʊf.`tɛk.'stɛn.dəʊf.`tɛk.'stɛn.dəʊf.`tɛk.'stɛn.dəʊf.`tɛk.'stɛn.dəʊf.`tɛk.'stɛn.dəʊf.`tɛk.'stɛn.dəʊf.`tɛk.'stɛn.dəʊf.`tɛk.'stɛn.dəʊf.`tɛkst
austerities	ɔː.'stɛ.ɹɪ.tɪz
h.r	`eɪ.'tʃɑ
17:4-6	'sɛ.vʌn.`tin.'kəʊ.lʌn.'fɔː.'dæʃ.'sɪks
u.h.l	`jʉː.`eɪ.'tʃɛl
h.g	`eɪtʃ.'dʒi
rss	`ɑ.`ɹɛ.'sɛs
bce	`bi.`si.'i
a.-f.c	'eɪ.`ɛf.'si
vol	'vɑl
quoted).<|endoftext|><|endoftext|><|endoftext	'kwəʊ.tɪ.'dɛn.dəʊf.`tɛk.'stɛn.dəʊf.`tɛk.'stɛn.dəʊf.`tɛkst
gods—those	'ɡɑdz.'ðəʊz
1254	'wɑn.'θaʊ.zʌnd.'tʉː.'hʌn.dɹʌ.dʌn.'fɪf.tɪ.'fɔː
r.l	`ɑ.'ɹɛl
1552<|endoftext|><|endoftext|><|endoftext|><|endoftext|><|endoftext|><|endoftext|><|endoftext|><|endoftext|><|endoftext|><|endoftext|><|endoftext|><|endoftext|><|endoftext|><|endoftext	'wɑn.'θaʊ.zʌnd.'faɪv.'hʌn.dɹʌ.dʌn.'fɪf.tɪ.'tʉː.'ɛn.dəʊf.`tɛk.'stɛn.dəʊf.`tɛk.'stɛn.dəʊf.`tɛk.'stɛn.dəʊf.`tɛk.'stɛn.dəʊf.`tɛk.'stɛn.dəʊf.`tɛk.'stɛn.dəʊf.`tɛk.'stɛn.dəʊf.`tɛk.'stɛn.dəʊf.`tɛk.'stɛn.dəʊf.`tɛk.'stɛn.dəʊf.`tɛk.'stɛn.dəʊf.`tɛk.'stɛn.dəʊf.`tɛk.'stɛn.dəʊf.`tɛkst
haldane	'hæl.deɪn
1985	'naɪn.tin.'hʌn.dɹʌ.dʌ.'neɪ.tɪ.'faɪv
pgs	`pi.`dʒi.'ɛs
9-12	'naɪn.'dæʃ.'twɛlv
prophe	'pɹɑf
4.6-7	'fɔː.pɔɪnt.'sɪks.'dæʃ.'sɛ.vʌn
eternalism	ɪ.'təː.nʌ.`lɪ.zʌm
27	'twɛn.tɪ.'sɛ.vʌn
one—who	'wɑn.'hʉː
estuivance	'ɛst.jʉː.`ɪ.vʌns
heils	'heɪlz
aroldine	'æ.ɹəʊl.`din
hearkened	'hɑ.kʌnd
judaica	dʒʉː.'deɪ.kʌ
else—if	'ɛl.sɪf
her-like	həː.'laɪk
one-hundred	'wɑn.'hʌn.dɹʌd
humanoids	'hjʉː.mʌ.`nɔɪdz
pureest	'pjʊə.ɹist
good.<|endoftext|><|endoftext|><|endoftext|><|endoftext|><|endoftext|><|endoftext|><|endoftext|><|endoftext|><|endoftext|><|endoftext|><|endoftext|><|endoftext|><|endoftext|><|endoftext|><|endoftext|><|endoftext	'ɡʊə.'dɛn.dəʊf.`tɛk.'stɛn.dəʊf.`tɛk.'stɛn.dəʊf.`tɛk.'stɛn.dəʊf.`tɛk.'stɛn.dəʊf.`tɛk.'stɛn.dəʊf.`tɛk.'stɛn.dəʊf.`tɛk.'stɛn.dəʊf.`tɛk.'stɛn.dəʊf.`tɛk.'stɛn.dəʊf.`tɛk.'stɛn.dəʊf.`tɛk.'stɛn.dəʊf.`tɛk.'stɛn.dəʊf.`tɛk.'stɛn.dəʊf.`tɛk.'stɛn.dəʊf.`tɛk.'stɛn.dəʊf.`tɛkst
human.<|endoftext|><|endoftext|><|endoftext|><|endoftext|><|endoftext|><|endoftext|><|endoftext|><|endoftext|><|endoftext|><|endoftext|><|endoftext|><|endoftext|><|endoftext	'hjʉː.mʌ.'nɛn.dəʊf.`tɛk.'stɛn.dəʊf.`tɛk.'stɛn.dəʊf.`tɛk.'stɛn.dəʊf.`tɛk.'stɛn.dəʊf.`tɛk.'stɛn.dəʊf.`tɛk.'stɛn.dəʊf.`tɛk.'stɛn.dəʊf.`tɛk.'stɛn.dəʊf.`tɛk.'stɛn.dəʊf.`tɛk.'stɛn.dəʊf.`tɛk.'stɛn.dəʊf.`tɛk.'stɛn.dəʊf.`tɛkst
men—they	'mɛn.ðeɪ
sicknesses	'sɪk.nʌ.sɪz
good—that	'ɡʊəd.'ðæt
good-nature	'ɡʊəd.'neɪ.tʃʌ
unforgetable	ʌn.fʌ.'ɡɛ.tʌ.bʌl
evilness	'i.vʌl.nʌs
is—and	ɪ.'zænd
wickedness—that	'wɪ.kɪd.nʌs.'ðæt
abilities—but	ʌ.'bɪ.lʌ.`tɪz.`bʌt
1st	'fəːst
long-gone	'lɑŋ.'ɡɑn
unto-do	`ʌn.tʊə.'dʉː
others,they	'ʌ.ðʌz.ðeɪ
obliteration	ʌ.`blɪ.tʌ.'ɹeɪ.ʃʌn
together—but	tʌ.'ɡɛ.ðʌ.`bʌt
seemly	'sim.lɪ
cold,ever	'kəʊl.'dɛ.vʌ
unfulfilled—in	ʌn.fʊəl.'fɪl.'dɪn
17:40	'sɛ.vʌn.`tin.'fɔː.tɪ
this-and-that	ðɪ.sænd.'ðæt
do.<|endoftext|><|endoftext|><|endoftext|><|endoftext|><|endoftext|><|endoftext|><|endoftext|><|endoftext|><|endoftext|><|endoftext|><|endoftext|><|endoftext|><|endoftext|><|endoftext|><|endoftext|><|endoftext|><|endoftext	'dʉː.'ɛn.dəʊf.`tɛk.'stɛn.dəʊf.`tɛk.'stɛn.dəʊf.`tɛk.'stɛn.dəʊf.`tɛk.'stɛn.dəʊf.`tɛk.'stɛn.dəʊf.`tɛk.'stɛn.dəʊf.`tɛk.'stɛn.dəʊf.`tɛk.'stɛn.dəʊf.`tɛk.'stɛn.dəʊf.`tɛk.'stɛn.dəʊf.`tɛk.'stɛn.dəʊf.`tɛk.'stɛn.dəʊf.`tɛk.'stɛn.dəʊf.`tɛk.'stɛn.dəʊf.`tɛk.'stɛn.dəʊf.`tɛk.'stɛn.dəʊf.`tɛkst
hearken	'hɑ.kʌn
do—or	'dʉː.ɔː
dead—at	'dɛ.dæt
blood-drenched	'blʌd.'dɹɛntʃt
8:11	'eɪ.tɪ.'lɛ.vʌn
2-4	'tʉː.'dæʃ.'fɔː
searche	'səːtʃ
5-6	'faɪv.'dæʃ.'sɪks
7:31	'sɛ.vʌn.'θəː.tɪ.'wɑn
unbeliever	ʌn.bɪ.'li.vʌ
believe—that	bɪ.'liv.'ðæt
mind-power	'maɪnd.'paʊ.ʌ
weepiness	'wi.pɪ.nʌs
impious	ɪm.pɪ.'ʌs
well-regulated	'wɛl.'ɹɛ.ɡjʉː.`leɪ.tɪd
know-nothing-about-things-can-be-done	'nəʊ.'nʌ.θɪŋ.ʌ.`baʊt.'θɪŋz.kæn.bi.'dʌn
2b	'tʉː.'bi
2:10	'tʉː.'tɛn
pursuance	pʌs.'jʉː.ʌns
herbic	'həː.bɪk
beliefs—what	bɪ.'lif.'swɑt
blaspheme	blæ.'sfim
11:2	ɪ.'lɛ.vʌn.'kəʊ.lʌn.'tʉː
2:49	'tʉː.'fɔː.tɪ.'naɪn
6:21	'sɪks.'twɛn.tɪ.'wɑn
1:14	'wɑn.'fɔː.tin
estus	'ɛ.stʌs
unchangeable	ʌn.'tʃeɪn.dʒʌ.bʌl
6:2—"for	'sɪk.'skəʊ.lʌn.'tʉː.'bæk.slæʃ.fɔː
6:2	'sɪk.'skəʊ.lʌn.'tʉː
hebdo	'hɛb.dəʊ
things--not	'θɪŋz.'nɑt
7:15	'sɛ.vʌn.'fɪf.tin
prophecyly	'pɹɑ.fʌ.sɪ.lɪ
3:14	'θɹi.'fɔː.tin
amen.<|endoftext|><|endoftext|><|endoftext|><|endoftext|><|endoftext|><|endoftext|><|endoftext	`ɑ.'mɛ.'nɛn.dəʊf.`tɛk.'stɛn.dəʊf.`tɛk.'stɛn.dəʊf.`tɛk.'stɛn.dəʊf.`tɛk.'stɛn.dəʊf.`tɛk.'stɛn.dəʊf.`tɛk.'stɛn.dəʊf.`tɛkst
all-mighty	'ɔːl.'maɪ.tɪ
enemy."<|endoftext|><|endoftext|><|endoftext|><|endoftext|><|endoftext|><|endoftext|><|endoftext|><|endoftext|><|endoftext|><|endoftext|><|endoftext|><|endoftext|><|endoftext|><|endoftext	'ɛ.nʌ.mɪ.'dɑt.bʌk.`slæ.'ʃɛn.dəʊf.`tɛk.'stɛn.dəʊf.`tɛk.'stɛn.dəʊf.`tɛk.'stɛn.dəʊf.`tɛk.'stɛn.dəʊf.`tɛk.'stɛn.dəʊf.`tɛk.'stɛn.dəʊf.`tɛk.'stɛn.dəʊf.`tɛk.'stɛn.dəʊf.`tɛk.'stɛn.dəʊf.`tɛk.'stɛn.dəʊf.`tɛk.'stɛn.dəʊf.`tɛk.'stɛn.dəʊf.`tɛk.'stɛn.dəʊf.`tɛkst
betwixt	bɪ.'twɪkst
tainmai	'teɪn.maɪ
1781	'wɑn.'θaʊ.zʌnd.'sɛ.vʌn.'hʌn.dɹʌ.dʌ.'neɪ.tɪ.'wɑn
s]oever	'ɛ.`səʊ.'ɛ.vʌ
fallewell	'fɔː.lʉː.`ɛl
kinswoman	'kɪn.swʊə.mʌn
e.m.c	`i.`ɛm.'si
it.'<|endoftext|><|endoftext|><|endoftext|><|endoftext|><|endoftext|><|endoftext|><|endoftext|><|endoftext|><|endoftext|><|endoftext|><|endoftext|><|endoftext|><|endoftext|><|endoftext|><|endoftext	ɪt.'dɑt.bʌk.`slæ.'ʃɛn.dəʊf.`tɛk.'stɛn.dəʊf.`tɛk.'stɛn.dəʊf.`tɛk.'stɛn.dəʊf.`tɛk.'stɛn.dəʊf.`tɛk.'stɛn.dəʊf.`tɛk.'stɛn.dəʊf.`tɛk.'stɛn.dəʊf.`tɛk.'stɛn.dəʊf.`tɛk.'stɛn.dəʊf.`tɛk.'stɛn.dəʊf.`tɛk.'stɛn.dəʊf.`tɛk.'stɛn.dəʊf.`tɛk.'stɛn.dəʊf.`tɛk.'stɛn.dəʊf.`tɛkst
so—i	`səʊ.'aɪ
house-chamber	'haʊs.'tʃeɪm.bʌ
endoftext|><|endoftext|><|endoftext|><|endoftext	'ɛn.dəʊf.`tɛk.'stɛn.dəʊf.`tɛk.'stɛn.dəʊf.`tɛk.'stɛn.dəʊf.`tɛkst
deed!<|endoftext|><|endoftext|><|endoftext	'di.'dɛn.dəʊf.`tɛk.'stɛn.dəʊf.`tɛk.'stɛn.dəʊf.`tɛkst
t]he	'ti.hi
lessness	'lɛ.snʌs
endoftext|><|endoftext|><|endoftext|><|endoftext|><|endoftext|><|endoftext	'ɛn.dəʊf.`tɛk.'stɛn.dəʊf.`tɛk.'stɛn.dəʊf.`tɛk.'stɛn.dəʊf.`tɛk.'stɛn.dəʊf.`tɛk.'stɛn.dəʊf.`tɛkst
one-year-old	'wɑn.'jeɪ.ʌ.'ɹəʊld
two-spirit	'tʉː.'spɪ.ɹɪt
suretiness	'ʃʊə.ɹʌ.`tɪ.nʌs
souciour	'saʊs.jʌ
remain[pg	ɹɪ.'meɪn.`pi.'dʒi
40	'fɔː.tɪ
reproachful	ɹɪ.'pɹəʊtʃ.fʌl
in's	ɪn.'bæk.slæ.'ʃɛs
seemedly	'si.mɪd.lɪ
properness	'pɹɑ.pʌ.nʌs
life-giving	'laɪf.'ɡɪ.vɪŋ
two-thirds	'tʉː.'θəːdz
wereest	'wəː.ɛst
sweet-hearted	'swit.'hɑ.tɪd
hehe	hi.'hi
mmm	`ɛ.`mɛ.'mɛm
fears—my	'feɪ.ʌz.'maɪ
2nd	'sɛ.kʌnd
sess	'sɛs
facebook	'feɪs.bʊək
meaninglessness	'mi.nɪŋ.lʌ.snʌs
j.r	`dʒeɪ.'ɑ
twitter	'twɪ.tʌ
endoftext|><|endoftext|><|endoftext|><|endoftext|><|endoftext|><|endoftext|><|endoftext|><|endoftext	'ɛn.dəʊf.`tɛk.'stɛn.dəʊf.`tɛk.'stɛn.dəʊf.`tɛk.'stɛn.dəʊf.`tɛk.'stɛn.dəʊf.`tɛk.'stɛn.dəʊf.`tɛk.'stɛn.dəʊf.`tɛk.'stɛn.dəʊf.`tɛkst
hobbit	'hɑ.bɪt
head-turners	'hɛd.'təː.nʌz
out-of-context	`aʊ.tʌv.'kɑn.tɛkst
awakeneth	ʌ.'weɪ.ki.nʌθ
thes	ðz
bewail	bɪ.'weɪl
7.21	'sɛ.vʌn.pɔɪnt.'tʉː.'wɑn
s.e.d	`ɛ.`si.'di
ifst	'ɪfst
canest	'keɪ.nʌst
recompence	`ɹi.kʌm.'pɛns
exaltation	ɛɡ.zʌl.'teɪ.ʃʌn
recompendent	`ɹi.kʌm.'pɛn.dʌnt
recomponement	`ɹi.kʌm.'pəʊn.mʌnt
sittest	'sɪ.tʌst
recompensed	'ɹɛ.kʌm.`pɛnsd
letthy	'lɛt.θɪ
willst	'wɪlst
in-place	ɪn.'pleɪs
thim	'θɪm
wrathful	'ɹæθ.fʌl
goest	'ɡəʊst
fellow-citizens	'fɛ.ləʊ.'sɪ.tɪ.zʌnz
christ-father	'kɹaɪst.'fɑ.ðʌ
thie	'θaɪ
sinst	'sɪnst
maidenhood	'meɪ.dʌn.`hʊəd
110	'wɑn.'hʌn.dɹʌ.dʌn.'tɛn
sinless	'sɪn.lʌs
servant's	'səː.vʌnt.'bæk.slæ.'ʃɛs
tertullian	təː.'tʌ.leɪ.ʌn
thee.'--isaiah	`ði.'dɑt.bʌk.`slæ.'ʃɪ.seɪ.ʌ
23:34	'twɛn.tɪ.'θɹi.'θəː.tɪ.'fɔː
untaken	ʌn.'teɪ.kʌn
defiled	dɪ.'faɪld
to-morrow	tʌ.'mɑ.ɹəʊ
to-midnight	tʌ.'mɪd.naɪt
8:1-3	'eɪt.'kəʊ.lʌn.'wɑn.'dæʃ.'θɹi
ibid	'ɪ.bɪd
t)he	'ti.hi
repenteth	ɹɪ.'pɛn.tʌθ
hastiness	'heɪ.stɪ.nʌs
childhood's	'tʃaɪld.hʊəd.'bæk.slæ.'ʃɛs
believeest	bɪ.'li.vist
ungodliness	ʌn.'ɡɑd.lɪ.nʌs
inestimable	ɪ.'nɛ.stɪ.mʌ.bʌl
wasst	'wɑst
gavest	'ɡeɪ.vʌst
sayst	'seɪst
bertolero	`bəː.tʌ.'ləː.ɹəʊ
meest	'mist
m1:2	'ɛm.'wɑn.'kəʊ.lʌn.'tʉː
aha-hah	ɑ.'hɑ.'hɑ
lovest	'lʌ.vɛst
knowst	'nəʊst
covereth	'kʌ.vʌ.ɹʌθ
me."and	`mi.'dɑt.bʌk.`slæ.ʃænd
knowt	'nəʊt
1:30	'wɑn.'θəː.tɪ
thineself	θaɪn.'sɛlf
confessest	kʌn.'fɛ.sʌst
livest	'laɪvst
al-qur'an	'æl.kwʌɹ.'bæk.slæ.ʃʌn
knoweth	'nəʊ.ʌθ
believest	bɪ.'li.vɛst
oughtst	'ɔːtst
stealed	'stild
4:1	'fɔː.'kəʊ.lʌn.'wɑn
mine—no	'maɪn.'nəʊ
lk	`ɛl.'keɪ
nefesh	'nɛ.fɛʃ
mortalised	'mɔː.tʌ.`laɪzd
sayth	'seɪθ
thou'llst	'ðaʊ.'bæk.slæ.`ʃɛ.`lɛ.`lɛ.'sti
fellow-servants	'fɛ.ləʊ.'səː.vʌnts
reconciler	'ɹɛ.kʌn.`saɪ.lʌ
darest	'dəː.ɹʌst
1t	'wɑn.'ti
misfellowship	mɪ.'sfɛ.ləʊ.`ʃɪp
foresworn	'fɔː.swɔːn
givest	'ɡɪ.vɛst
well-fed	'wɛl.'fɛd
fore-of-life	'fɔː.ɹɑv.'laɪf
belongeth	bɪ.'lɑŋ.ʌθ
sentest	'sɛn.tʌst
lxxii	`ɛ.'lɛks.'zɪ.aɪ
havest	'heɪ.vʌst
caught.<|endoftext|><|endoftext|><|endoftext|><|endoftext|><|endoftext|><|endoftext|><|endoftext|><|endoftext|><|endoftext|><|endoftext|><|endoftext	'kɔː.'tɛn.dəʊf.`tɛk.'stɛn.dəʊf.`tɛk.'stɛn.dəʊf.`tɛk.'stɛn.dəʊf.`tɛk.'stɛn.dəʊf.`tɛk.'stɛn.dəʊf.`tɛk.'stɛn.dəʊf.`tɛk.'stɛn.dəʊf.`tɛk.'stɛn.dəʊf.`tɛk.'stɛn.dəʊf.`tɛk.'stɛn.dəʊf.`tɛkst
ox's	'ɑks.'bæk.slæ.'ʃɛs
unself	ʌn.'sɛlf
unfor	ʌn.'fɔː
makest	'meɪ.kʌst
understandest	`ʌn.dʌ.'stæn.dʌst
sheweth	'ʃəʊ.ʌθ
eth	'ɛθ
unbindeth	ʌn.'baɪn.dʌθ
cause—that	'kɔːz.'ðæt
unblameless	ʌn.'bleɪm.lʌs
ownself	əʊn.'sɛlf
un-bound	'ʌn.'baʊnd
hereth	'hɛ.ɹʌθ
exod	ɛɡ.'zɑd
xxix-xxix	`ɹəʊ.mʌn.'twɛn.tɪ.'naɪn.`ɹəʊ.mʌn.'twɛn.tɪ.'naɪn
bondman	'bɑnd.mʌn
wrathfulness	'ɹæθ.fʌl.nʌs
unbinds	ʌn.'baɪndz
unleshes	ʌn.'lɛ.ʃɪz
disgracefully	dɪs.'ɡɹeɪ.sfʌ.lɪ
disreputest	`dɪs.ɹɪ.'pjʉː.tʌst
unheld	ʌn.'hɛld
power-loving	'paʊ.ʌ.'lʌ.vɪŋ
lookest	'lʊə.kʌst
slieth	'slaɪ.ʌθ
thir	'θəː
accuser.<|endoftext|><|endoftext|><|endoftext|><|endoftext|><|endoftext|><|endoftext	ʌ.'kjʉː.zʌ.'ɛn.dəʊf.`tɛk.'stɛn.dəʊf.`tɛk.'stɛn.dəʊf.`tɛk.'stɛn.dəʊf.`tɛk.'stɛn.dəʊf.`tɛk.'stɛn.dəʊf.`tɛkst
oughtest	'ɔː.tʌst
thofe	'θəʊf
neighbour's	'neɪ.bʌ.'bæk.slæ.'ʃɛs
judgeest	'dʒʌ.dʒʌst
muste	'mʌst
accuser's	ʌ.'kjʉː.zʌ.'bæk.slæ.'ʃɛs
liar's	'laɪ.ʌ.'bæk.slæ.'ʃɛs
aeopor	'i.ɑ.pʌ
lxx	`ɛ.`lɛk.'sɛks
shamefully	'ʃeɪm.fʌ.lɪ
thar'den	'θɑ.'bæk.slæʃ.'dɛn
swelter'st	'swɛl.tʌ.'bæk.slæʃ.sʌnt
abdu'l	'æb.dʉː.'bæk.slæ.'ʃɛl
thyself's	θaɪ.'sɛlf.'bæk.slæ.'ʃɛs
2)--the	'tʉː.ðʌ
confesseth	kʌn.'fɛ.sʌθ
thu'r	'θəː.'bæk.slæ.'ʃɑ
ps	`pi.'ɛs
saidst	'sɛdst
word:--yet	'wəːd.'kəʊ.lʌn.'jɛt
18)--again	'eɪ.ti.nʌ.'ɡɛn
2--dedication	'tʉː.`dɛ.dɪ.'keɪ.ʃʌn
yea-behold	'jeɪ.bɪ.'həʊld
therewithst	ðəː.'wɪðst
knewest	'njʉː.ʌst
ehear	'ɛ.heɪ.ʌ
lxxxi	`ɛ.`lɛk.'sɛk.`sɛk.'saɪ
ameth	'eɪ.mʌθ
one-eyed	'wɑ.'naɪd
yea-forever	'jeɪ.fʌ.'ɹɛ.vʌ
shallst	'ʃɔːlst
yea-believed	'jeɪ.bɪ.'livd
wentest	'wɛn.tʌst
no-one	'nəʊ.'wɑn
yea-thine	'jeɪ.`ðaɪn
asketh	'æ.skʌθ
unrighteousness	ʌn.'ɹaɪ.tʃʌ.snʌs
unconquer	ʌn.'kɑn.kʌ
sword-and-bough	'sɔː.dænd.'baʊ
loins	'lɔɪnz
all-powerful	'ɔːl.'paʊ.ʌ.fʌl
sayeth	'seɪ.ɛθ
believeth	bɪ.'li.vʌθ
reigneth	'ɹeɪ.nʌθ
19:27-28	'naɪn.tin.'twɛn.tɪ.'sɛ.vʌn.'dæʃ.'twɛn.tɪ.'eɪt
3and	'θɹi.ænd
god-fearer	'ɡɑd.'feɪ.ʌ.ɹʌ
mye	'maɪ
saviour	'seɪ.vjʌ
beeth	'biθ
saidest	'sɛ.dʌst
vexation	vɛk.'seɪ.ʃʌn
shallest	'ʃæ.lʌst
g‑d	'dʒi.'di
withest	'wɪ.ðʌst
lordship	'lɔːd.ʃɪp
souldest	'səʊl.dʌst
saveth	'seɪ.vʌθ
eliath	ɪ.'laɪ.ʌθ
salliness	'sæ.lɪ.nʌs
goddiest	'ɡɑ.dɪ.ʌst
peace!<|endoftext|><|endoftext|><|endoftext|><|endoftext|><|endoftext|><|endoftext|><|endoftext|><|endoftext	'pi.'sɛn.dəʊf.`tɛk.'stɛn.dəʊf.`tɛk.'stɛn.dəʊf.`tɛk.'stɛn.dəʊf.`tɛk.'stɛn.dəʊf.`tɛk.'stɛn.dəʊf.`tɛk.'stɛn.dəʊf.`tɛk.'stɛn.dəʊf.`tɛkst
483	'fɔː.'hʌn.dɹʌ.dʌ.'neɪ.tɪ.'θɹi
end.<|endoftext|><|endoftext|><|endoftext|><|endoftext|><|endoftext|><|endoftext|><|endoftext|><|endoftext|><|endoftext|><|endoftext|><|endoftext|><|endoftext|><|endoftext|><|endoftext|><|endoftext|><|endoftext	'ɛn.'dɛn.dəʊf.`tɛk.'stɛn.dəʊf.`tɛk.'stɛn.dəʊf.`tɛk.'stɛn.dəʊf.`tɛk.'stɛn.dəʊf.`tɛk.'stɛn.dəʊf.`tɛk.'stɛn.dəʊf.`tɛk.'stɛn.dəʊf.`tɛk.'stɛn.dəʊf.`tɛk.'stɛn.dəʊf.`tɛk.'stɛn.dəʊf.`tɛk.'stɛn.dəʊf.`tɛk.'stɛn.dəʊf.`tɛk.'stɛn.dəʊf.`tɛk.'stɛn.dəʊf.`tɛk.'stɛn.dəʊf.`tɛkst
all-wise	'ɔːl.'waɪz
father,and	'fɑ.ðʌ.ɹænd
aigis	'eɪ.ɡɪz
soever	`səʊ.'ɛ.vʌ
mercy,or,the	'məː.sɪ.ɔː.ðʌ
i-man	aɪ.'mæn
sainte	'seɪnt
8.29-40)--then	'eɪt.pɔɪnt.'tʉː.'naɪn.'dæʃ.'fɔː.tɪ.'ðɛn
iniquities	ɪ.'nɪ.kwɪ.tɪz
anon	ʌ.'nɑn
amen.<|endoftext|><|endoftext|><|endoftext|><|endoftext|><|endoftext|><|endoftext|><|endoftext|><|endoftext|><|endoftext|><|endoftext|><|endoftext|><|endoftext	`ɑ.'mɛ.'nɛn.dəʊf.`tɛk.'stɛn.dəʊf.`tɛk.'stɛn.dəʊf.`tɛk.'stɛn.dəʊf.`tɛk.'stɛn.dəʊf.`tɛk.'stɛn.dəʊf.`tɛk.'stɛn.dəʊf.`tɛk.'stɛn.dəʊf.`tɛk.'stɛn.dəʊf.`tɛk.'stɛn.dəʊf.`tɛk.'stɛn.dəʊf.`tɛk.'stɛn.dəʊf.`tɛkst
waste,nor	'weɪst.'nɔː
daughter-in-law	'dɔː.tʌ.ɹɪn.'lɔː
al-'amir	'æl.'bæk.slæ.'ʃæ.meɪ.ʌ
heirless	'əː.lʌs
a1:46	`eɪ.'wɑn.'fɔː.tɪ.'sɪks
earth.<|endoftext|><|endoftext|><|endoftext|><|endoftext|><|endoftext|><|endoftext|><|endoftext|><|endoftext|><|endoftext|><|endoftext|><|endoftext	'əː.'θɛn.dəʊf.`tɛk.'stɛn.dəʊf.`tɛk.'stɛn.dəʊf.`tɛk.'stɛn.dəʊf.`tɛk.'stɛn.dəʊf.`tɛk.'stɛn.dəʊf.`tɛk.'stɛn.dəʊf.`tɛk.'stɛn.dəʊf.`tɛk.'stɛn.dəʊf.`tɛk.'stɛn.dəʊf.`tɛk.'stɛn.dəʊf.`tɛkst
lxxiii	`ɛ.'lɛks.'zɪ.ɪ.`aɪ
tolmos	'tɑl.məʊz
well-bred	'wɛl.'bɹɛd
liveth	'laɪvθ
slays	'sleɪz
great-uncle	'ɡɹeɪ.'tʌŋ.kʌl
heir-ship	'əː.'ʃɪp
behoves	bɪ.'həʊvz
xxvii	`ɹəʊ.mʌn.'twɛn.tɪ.'sɛ.vʌn
sura-na	'səː.ɹʌ.'nɑ
8.14)<|endoftext|><|endoftext|><|endoftext|><|endoftext|><|endoftext|><|endoftext|><|endoftext|><|endoftext|><|endoftext	'eɪt.pɔɪn.'twɑn.'fɔː.'ɛn.dəʊf.`tɛk.'stɛn.dəʊf.`tɛk.'stɛn.dəʊf.`tɛk.'stɛn.dəʊf.`tɛk.'stɛn.dəʊf.`tɛk.'stɛn.dəʊf.`tɛk.'stɛn.dəʊf.`tɛk.'stɛn.dəʊf.`tɛk.'stɛn.dəʊf.`tɛkst
60-a:11-12	'sɪk.stɪ.ʌ.'kəʊ.lʌ.nɪ.'lɛ.vʌn.'dæʃ.'twɛlv
spared.<|endoftext|><|endoftext|><|endoftext|><|endoftext|><|endoftext|><|endoftext|><|endoftext|><|endoftext|><|endoftext|><|endoftext|><|endoftext|><|endoftext	'spəː.'dɛn.dəʊf.`tɛk.'stɛn.dəʊf.`tɛk.'stɛn.dəʊf.`tɛk.'stɛn.dəʊf.`tɛk.'stɛn.dəʊf.`tɛk.'stɛn.dəʊf.`tɛk.'stɛn.dəʊf.`tɛk.'stɛn.dəʊf.`tɛk.'stɛn.dəʊf.`tɛk.'stɛn.dəʊf.`tɛk.'stɛn.dəʊf.`tɛk.'stɛn.dəʊf.`tɛkst
ecclesiastes	ɪ.'kli.zɪ.`æsts
sweat.so	'swɛt.'dɑt.'səʊ
thee.<|endoftext|><|endoftext|><|endoftext|><|endoftext|><|endoftext|><|endoftext|><|endoftext|><|endoftext|><|endoftext|><|endoftext|><|endoftext	'ði.'ɛn.dəʊf.`tɛk.'stɛn.dəʊf.`tɛk.'stɛn.dəʊf.`tɛk.'stɛn.dəʊf.`tɛk.'stɛn.dəʊf.`tɛk.'stɛn.dəʊf.`tɛk.'stɛn.dəʊf.`tɛk.'stɛn.dəʊf.`tɛk.'stɛn.dəʊf.`tɛk.'stɛn.dəʊf.`tɛk.'stɛn.dəʊf.`tɛkst
him.<|endoftext|><|endoftext|><|endoftext|><|endoftext|><|endoftext|><|endoftext|><|endoftext|><|endoftext|><|endoftext|><|endoftext|><|endoftext|><|endoftext	'hɪ.'mɛn.dəʊf.`tɛk.'stɛn.dəʊf.`tɛk.'stɛn.dəʊf.`tɛk.'stɛn.dəʊf.`tɛk.'stɛn.dəʊf.`tɛk.'stɛn.dəʊf.`tɛk.'stɛn.dəʊf.`tɛk.'stɛn.dəʊf.`tɛk.'stɛn.dəʊf.`tɛk.'stɛn.dəʊf.`tɛk.'stɛn.dəʊf.`tɛk.'stɛn.dəʊf.`tɛkst
live,<|endoftext|><|endoftext|><|endoftext|><|endoftext|><|endoftext|><|endoftext|><|endoftext|><|endoftext|><|endoftext|><|endoftext|><|endoftext|><|endoftext	'laɪ.'vɛn.dəʊf.`tɛk.'stɛn.dəʊf.`tɛk.'stɛn.dəʊf.`tɛk.'stɛn.dəʊf.`tɛk.'stɛn.dəʊf.`tɛk.'stɛn.dəʊf.`tɛk.'stɛn.dəʊf.`tɛk.'stɛn.dəʊf.`tɛk.'stɛn.dəʊf.`tɛk.'stɛn.dəʊf.`tɛk.'stɛn.dəʊf.`tɛk.'stɛn.dəʊf.`tɛkst
servant-servant	'səː.vʌnt.'səː.vʌnt
love.[6	'lʌv.'sɪks
p-p	'pi.'pi
on.[6	'ɑn.'sɪks
me.<|endoftext|><|endoftext|><|endoftext|><|endoftext|><|endoftext|><|endoftext|><|endoftext|><|endoftext|><|endoftext|><|endoftext|><|endoftext	'mi.'ɛn.dəʊf.`tɛk.'stɛn.dəʊf.`tɛk.'stɛn.dəʊf.`tɛk.'stɛn.dəʊf.`tɛk.'stɛn.dəʊf.`tɛk.'stɛn.dəʊf.`tɛk.'stɛn.dəʊf.`tɛk.'stɛn.dəʊf.`tɛk.'stɛn.dəʊf.`tɛk.'stɛn.dəʊf.`tɛk.'stɛn.dəʊf.`tɛkst
speaketh	'spi.kʌθ
whereon	'wəː.ɹɑn
whoso	'hʉː.səʊ
tuo	'tjʉː.əʊ
quelques	'kwɛlks
inuens	ɪn.'jʉː.ʌnz
whomesoever	`hʉː.mɪ.`səʊ.'ɛ.vʌ
whome	'hʉːm
blasphemed	blæ.'sfimd
death.<|endoftext|><|endoftext|><|endoftext|><|endoftext|><|endoftext|><|endoftext|><|endoftext|><|endoftext|><|endoftext|><|endoftext|><|endoftext|><|endoftext|><|endoftext	'dɛ.'θɛn.dəʊf.`tɛk.'stɛn.dəʊf.`tɛk.'stɛn.dəʊf.`tɛk.'stɛn.dəʊf.`tɛk.'stɛn.dəʊf.`tɛk.'stɛn.dəʊf.`tɛk.'stɛn.dəʊf.`tɛk.'stɛn.dəʊf.`tɛk.'stɛn.dəʊf.`tɛk.'stɛn.dəʊf.`tɛk.'stɛn.dəʊf.`tɛk.'stɛn.dəʊf.`tɛk.'stɛn.dəʊf.`tɛkst
whos	'hʉːz
wise-natured	'waɪz.'neɪ.tʃʌd
amen.<|endoftext|><|endoftext|><|endoftext|><|endoftext|><|endoftext|><|endoftext|><|endoftext|><|endoftext|><|endoftext|><|endoftext|><|endoftext	`ɑ.'mɛ.'nɛn.dəʊf.`tɛk.'stɛn.dəʊf.`tɛk.'stɛn.dəʊf.`tɛk.'stɛn.dəʊf.`tɛk.'stɛn.dəʊf.`tɛk.'stɛn.dəʊf.`tɛk.'stɛn.dəʊf.`tɛk.'stɛn.dəʊf.`tɛk.'stɛn.dəʊf.`tɛk.'stɛn.dəʊf.`tɛk.'stɛn.dəʊf.`tɛkst
whithersoever	`wɪ.ðʌ.`səʊ.'ɛ.vʌ
mighteth	'maɪ.tʌθ
weel	'wil
fellow-men	'fɛ.ləʊ.'mɛn
to-night	tʌ.'naɪt
chrysostom	'kɹaɪ.sɑ.stʌm
believe?<|endoftext|><|endoftext|><|endoftext|><|endoftext|><|endoftext|><|endoftext|><|endoftext|><|endoftext|><|endoftext|><|endoftext|><|endoftext|><|endoftext|><|endoftext|><|endoftext	bɪ.'li.'vɛn.dəʊf.`tɛk.'stɛn.dəʊf.`tɛk.'stɛn.dəʊf.`tɛk.'stɛn.dəʊf.`tɛk.'stɛn.dəʊf.`tɛk.'stɛn.dəʊf.`tɛk.'stɛn.dəʊf.`tɛk.'stɛn.dəʊf.`tɛk.'stɛn.dəʊf.`tɛk.'stɛn.dəʊf.`tɛk.'stɛn.dəʊf.`tɛk.'stɛn.dəʊf.`tɛk.'stɛn.dəʊf.`tɛk.'stɛn.dəʊf.`tɛkst
welpe	'wɛlp
an-dama	ʌn.'dɑ.mʌ
bringeth	'bɹɪŋ.ʌθ
endoftext|><|endoftext|><|endoftext|><|endoftext|><|endoftext|><|endoftext|><|endoftext|><|endoftext|><|endoftext|><|endoftext|><|endoftext|><|endoftext|><|endoftext|><|endoftext|><|endoftext	'ɛn.dəʊf.`tɛk.'stɛn.dəʊf.`tɛk.'stɛn.dəʊf.`tɛk.'stɛn.dəʊf.`tɛk.'stɛn.dəʊf.`tɛk.'stɛn.dəʊf.`tɛk.'stɛn.dəʊf.`tɛk.'stɛn.dəʊf.`tɛk.'stɛn.dəʊf.`tɛk.'stɛn.dəʊf.`tɛk.'stɛn.dəʊf.`tɛk.'stɛn.dəʊf.`tɛk.'stɛn.dəʊf.`tɛk.'stɛn.dəʊf.`tɛk.'stɛn.dəʊf.`tɛkst
psalmist	'sɑ.mɪst
wherewithst	'wəː.wɪðst
16)--for	'sɪk.stin.fɔː
believe.<|endoftext|><|endoftext|><|endoftext|><|endoftext|><|endoftext|><|endoftext|><|endoftext|><|endoftext|><|endoftext|><|endoftext	bɪ.'li.'vɛn.dəʊf.`tɛk.'stɛn.dəʊf.`tɛk.'stɛn.dəʊf.`tɛk.'stɛn.dəʊf.`tɛk.'stɛn.dəʊf.`tɛk.'stɛn.dəʊf.`tɛk.'stɛn.dəʊf.`tɛk.'stɛn.dəʊf.`tɛk.'stɛn.dəʊf.`tɛk.'stɛn.dəʊf.`tɛkst
7)--thou	'sɛ.vʌn.'ðaʊ
heb	'hɛb
cinem	'sɪ.nʌm
1)<|endoftext|><|endoftext|><|endoftext|><|endoftext|><|endoftext|><|endoftext|><|endoftext|><|endoftext|><|endoftext|><|endoftext|><|endoftext|><|endoftext	'wɑ.'nɛn.dəʊf.`tɛk.'stɛn.dəʊf.`tɛk.'stɛn.dəʊf.`tɛk.'stɛn.dəʊf.`tɛk.'stɛn.dəʊf.`tɛk.'stɛn.dəʊf.`tɛk.'stɛn.dəʊf.`tɛk.'stɛn.dəʊf.`tɛk.'stɛn.dəʊf.`tɛk.'stɛn.dəʊf.`tɛk.'stɛn.dəʊf.`tɛk.'stɛn.dəʊf.`tɛkst
doeth	'dəʊθ
1:27	'wɑn.'twɛn.tɪ.'sɛ.vʌn
4th.--and	'fɔː.θænd
willeth	'wɪ.lʌθ
4:13	'fɔː.'θəː.tin
neath	'niθ
doodeth	'dʉː.dʌθ
forth.<|endoftext|><|endoftext|><|endoftext|><|endoftext|><|endoftext|><|endoftext|><|endoftext	'fɔː.'θɛn.dəʊf.`tɛk.'stɛn.dəʊf.`tɛk.'stɛn.dəʊf.`tɛk.'stɛn.dəʊf.`tɛk.'stɛn.dəʊf.`tɛk.'stɛn.dəʊf.`tɛk.'stɛn.dəʊf.`tɛkst
death.<|endoftext|><|endoftext|><|endoftext|><|endoftext|><|endoftext|><|endoftext|><|endoftext|><|endoftext|><|endoftext|><|endoftext|><|endoftext|><|endoftext	'dɛ.'θɛn.dəʊf.`tɛk.'stɛn.dəʊf.`tɛk.'stɛn.dəʊf.`tɛk.'stɛn.dəʊf.`tɛk.'stɛn.dəʊf.`tɛk.'stɛn.dəʊf.`tɛk.'stɛn.dəʊf.`tɛk.'stɛn.dəʊf.`tɛk.'stɛn.dəʊf.`tɛk.'stɛn.dəʊf.`tɛk.'stɛn.dəʊf.`tɛk.'stɛn.dəʊf.`tɛkst
maynot	'meɪ.nɑt
tostil	'tɑ.stɪl
standeth	'stæn.dʌθ
1:9-11)<|endoftext	'wɑn.'kəʊ.lʌn.'naɪn.'dæ.ʃɪ.'lɛ.vʌ.'nɛn.dəʊf.`tɛkst
vii	`ɹəʊ.mʌn.'sɛ.vʌn
mayt	'meɪt
thirty-one	'θəː.tɪ.`wɑn
good-will	'ɡʊə.'dwɪl
man—no	'mæn.'nəʊ
3.17]"and	'θɹi.pɔɪn.'twɑn.'sɛ.vʌn.'bæk.slæ.ʃænd
tarthe	'tɑð
doesest	'dəʊ.sʌst
weepest	'wi.pʌst
warlike,and	'wɔː.laɪ.kænd
die,and	'daɪ.ænd
peace.the	'pis.'dɑt.ðʌ
him.<|endoftext|><|endoftext|><|endoftext|><|endoftext|><|endoftext|><|endoftext|><|endoftext|><|endoftext	'hɪ.'mɛn.dəʊf.`tɛk.'stɛn.dəʊf.`tɛk.'stɛn.dəʊf.`tɛk.'stɛn.dəʊf.`tɛk.'stɛn.dəʊf.`tɛk.'stɛn.dəʊf.`tɛk.'stɛn.dəʊf.`tɛk.'stɛn.dəʊf.`tɛkst
name.<|endoftext|><|endoftext|><|endoftext|><|endoftext|><|endoftext|><|endoftext|><|endoftext|><|endoftext|><|endoftext	'neɪ.'mɛn.dəʊf.`tɛk.'stɛn.dəʊf.`tɛk.'stɛn.dəʊf.`tɛk.'stɛn.dəʊf.`tɛk.'stɛn.dəʊf.`tɛk.'stɛn.dəʊf.`tɛk.'stɛn.dəʊf.`tɛk.'stɛn.dəʊf.`tɛk.'stɛn.dəʊf.`tɛkst
kingdom.<|endoftext|><|endoftext|><|endoftext|><|endoftext|><|endoftext|><|endoftext|><|endoftext|><|endoftext|><|endoftext|><|endoftext	'kɪŋ.dʌ.'mɛn.dəʊf.`tɛk.'stɛn.dəʊf.`tɛk.'stɛn.dəʊf.`tɛk.'stɛn.dəʊf.`tɛk.'stɛn.dəʊf.`tɛk.'stɛn.dəʊf.`tɛk.'stɛn.dəʊf.`tɛk.'stɛn.dəʊf.`tɛk.'stɛn.dəʊf.`tɛk.'stɛn.dəʊf.`tɛkst
covetous	'kʌ.vʌ.tʌs
hasts	'heɪsts
well-disposed	'wɛl.dɪ.'spəʊzd
sun-drops	'sʌn.'dɹɑps
h.h	`eɪ.'tʃeɪtʃ
tur-chi	'təː.'tʃaɪ
lahuas	'læ.hjʉː.ʌz
thak	'θæk
llanareth	læ.'nɑ.ɹʌθ
lhai	'laɪ
lian	'laɪ.ʌn
lih	'lɪ
laxus	'læk.sʌs
beholdest	bɪ.'həʊl.dʌst
whoest	'wəʊst
behooveth	bɪ.'hʉː.vʌθ
haveheld	'heɪv.hɛld
lakhch	'lækhtʃ
láthien	'læ.θeɪ.ʌn
myne	'maɪn
countenance.<|endoftext|><|endoftext|><|endoftext|><|endoftext|><|endoftext|><|endoftext|><|endoftext|><|endoftext	'kaʊn.tʌ.nʌn.'sɛn.dəʊf.`tɛk.'stɛn.dəʊf.`tɛk.'stɛn.dəʊf.`tɛk.'stɛn.dəʊf.`tɛk.'stɛn.dəʊf.`tɛk.'stɛn.dəʊf.`tɛk.'stɛn.dəʊf.`tɛk.'stɛn.dəʊf.`tɛkst
all-knowing	'ɔːl.'nəʊ.ɪŋ
tath	'tæθ
whosoest	'hʉː.səʊst
handest	'hæn.dʌst
lathis	'læ.θaɪz
day-sun	'deɪ.'sʌn
laith	'leɪθ
sawst	'sɔːst
lahu	'læ.hʉː
lik	'lɪk
liao-chao	'laɪ.ʌ.`ɹəʊ.'keɪ.əʊ
disciples,o	dɪ.'saɪ.pʌl.'zəʊ
mornicest	'mɔː.naɪ.sʌst
9th-2nd	'naɪnθ.'sɛ.kʌnd
findest	'faɪn.dʌst
again.<|endoftext|><|endoftext|><|endoftext|><|endoftext|><|endoftext|><|endoftext|><|endoftext|><|endoftext|><|endoftext|><|endoftext|><|endoftext	ʌ.'ɡɛ.'nɛn.dəʊf.`tɛk.'stɛn.dəʊf.`tɛk.'stɛn.dəʊf.`tɛk.'stɛn.dəʊf.`tɛk.'stɛn.dəʊf.`tɛk.'stɛn.dəʊf.`tɛk.'stɛn.dəʊf.`tɛk.'stɛn.dəʊf.`tɛk.'stɛn.dəʊf.`tɛk.'stɛn.dəʊf.`tɛk.'stɛn.dəʊf.`tɛkst
sooth	'sʉːð
maketh	'meɪ.kʌθ
lawgiver	'lɔː.ɡɪ.vʌ
greatness?[17	'ɡɹeɪt.nʌs.'sɛ.vʌn.`tin
called?<|endoftext|><|endoftext|><|endoftext|><|endoftext|><|endoftext|><|endoftext|><|endoftext|><|endoftext|><|endoftext|><|endoftext|><|endoftext	'kɔːl.'dɛn.dəʊf.`tɛk.'stɛn.dəʊf.`tɛk.'stɛn.dəʊf.`tɛk.'stɛn.dəʊf.`tɛk.'stɛn.dəʊf.`tɛk.'stɛn.dəʊf.`tɛk.'stɛn.dəʊf.`tɛk.'stɛn.dəʊf.`tɛk.'stɛn.dəʊf.`tɛk.'stɛn.dəʊf.`tɛk.'stɛn.dəʊf.`tɛkst
god.ye	'ɡɑd.'dɑt.'ji
mayhap	'meɪ.hæp
ways.<|endoftext|><|endoftext|><|endoftext|><|endoftext|><|endoftext|><|endoftext|><|endoftext|><|endoftext|><|endoftext|><|endoftext|><|endoftext	'weɪ.'zɛn.dəʊf.`tɛk.'stɛn.dəʊf.`tɛk.'stɛn.dəʊf.`tɛk.'stɛn.dəʊf.`tɛk.'stɛn.dəʊf.`tɛk.'stɛn.dəʊf.`tɛk.'stɛn.dəʊf.`tɛk.'stɛn.dəʊf.`tɛk.'stɛn.dəʊf.`tɛk.'stɛn.dəʊf.`tɛk.'stɛn.dəʊf.`tɛkst
godhood	'ɡɑd.hʊəd
father.<|endoftext|><|endoftext|><|endoftext|><|endoftext|><|endoftext|><|endoftext|><|endoftext	'fɑ.ðʌ.'ɛn.dəʊf.`tɛk.'stɛn.dəʊf.`tɛk.'stɛn.dəʊf.`tɛk.'stɛn.dəʊf.`tɛk.'stɛn.dəʊf.`tɛk.'stɛn.dəʊf.`tɛk.'stɛn.dəʊf.`tɛkst
bewails	bɪ.'weɪlz
christ.<|endoftext|><|endoftext|><|endoftext|><|endoftext|><|endoftext|><|endoftext|><|endoftext|><|endoftext|><|endoftext|><|endoftext|><|endoftext|><|endoftext	'kɹaɪ.'stɛn.dəʊf.`tɛk.'stɛn.dəʊf.`tɛk.'stɛn.dəʊf.`tɛk.'stɛn.dəʊf.`tɛk.'stɛn.dəʊf.`tɛk.'stɛn.dəʊf.`tɛk.'stɛn.dəʊf.`tɛk.'stɛn.dəʊf.`tɛk.'stɛn.dəʊf.`tɛk.'stɛn.dəʊf.`tɛk.'stɛn.dəʊf.`tɛk.'stɛn.dəʊf.`tɛkst
thyselves	θaɪ.'sɛlvz
14--felitude	'fɔː.tin.'fɛ.lɪt.`jʉːd
savior?--and	'seɪ.vjʌ.ænd
misgenderer	mɪs.'dʒɛn.dʌ.ɹʌ
live.<|endoftext|><|endoftext|><|endoftext|><|endoftext|><|endoftext|><|endoftext|><|endoftext|><|endoftext	'laɪ.'vɛn.dəʊf.`tɛk.'stɛn.dəʊf.`tɛk.'stɛn.dəʊf.`tɛk.'stɛn.dəʊf.`tɛk.'stɛn.dəʊf.`tɛk.'stɛn.dəʊf.`tɛk.'stɛn.dəʊf.`tɛk.'stɛn.dəʊf.`tɛkst
13:10)<|endoftext|><|endoftext|><|endoftext|><|endoftext|><|endoftext|><|endoftext|><|endoftext	'θəː.tin.'tɛ.'nɛn.dəʊf.`tɛk.'stɛn.dəʊf.`tɛk.'stɛn.dəʊf.`tɛk.'stɛn.dəʊf.`tɛk.'stɛn.dəʊf.`tɛk.'stɛn.dəʊf.`tɛk.'stɛn.dəʊf.`tɛkst
art.<|endoftext|><|endoftext|><|endoftext|><|endoftext|><|endoftext|><|endoftext	'ɑ.'tɛn.dəʊf.`tɛk.'stɛn.dəʊf.`tɛk.'stɛn.dəʊf.`tɛk.'stɛn.dəʊf.`tɛk.'stɛn.dəʊf.`tɛk.'stɛn.dəʊf.`tɛkst
a.t.v	`eɪ.`ti.'vi
tetragrammaton	'tɛ.tɹʌ.`ɡɹæ.mæ.tʌn
aai	'ɑ.ɹɪ
inherit.<|endoftext|><|endoftext|><|endoftext|><|endoftext|><|endoftext|><|endoftext|><|endoftext|><|endoftext	ɪn.'hɛ.ɹɪ.'tɛn.dəʊf.`tɛk.'stɛn.dəʊf.`tɛk.'stɛn.dəʊf.`tɛk.'stɛn.dəʊf.`tɛk.'stɛn.dəʊf.`tɛk.'stɛn.dəʊf.`tɛk.'stɛn.dəʊf.`tɛk.'stɛn.dəʊf.`tɛkst
2d	'tʉː.'di
sūrat	'səː.ɹæt
god.and	'ɡɑd.'dɑ.tænd
defile	dɪ.'faɪl
thygod	`ðaɪ.'ɡɑd
t]herefore	'ti.'hɛ.ɹɪ.`fɔː
g-d	'dʒi.'di
g-da	'dʒi.'dɑ
maidservant	'meɪd.səː.vʌnt
bearest	'bəː.ɹʌst
obeyth	'əʊ.bɪθ
thoth	'θɑθ
pietger	'paɪ.ʌt.dʒʌ
mother-in-law's	'mʌ.ðʌ.ɹɪn.'lɔː.'bæk.slæ.'ʃɛs
swar	'swɔː
end;-and	'ɛn.dænd
closest,and	'kləʊ.sʌ.stænd
prophet's	'pɹɑ.fɪt.'bæk.slæ.'ʃɛs
haveest	'hæ.vist
me?—aught	'mi.'ɔːt
all.<|endoftext|><|endoftext|><|endoftext|><|endoftext|><|endoftext|><|endoftext|><|endoftext|><|endoftext|><|endoftext|><|endoftext|><|endoftext|><|endoftext|><|endoftext|><|endoftext	'ɔː.'lɛn.dəʊf.`tɛk.'stɛn.dəʊf.`tɛk.'stɛn.dəʊf.`tɛk.'stɛn.dəʊf.`tɛk.'stɛn.dəʊf.`tɛk.'stɛn.dəʊf.`tɛk.'stɛn.dəʊf.`tɛk.'stɛn.dəʊf.`tɛk.'stɛn.dəʊf.`tɛk.'stɛn.dəʊf.`tɛk.'stɛn.dəʊf.`tɛk.'stɛn.dəʊf.`tɛk.'stɛn.dəʊf.`tɛk.'stɛn.dəʊf.`tɛkst
arest	'əː.ɹʌst
thoughtst	'θɔːtst
31:10)<|endoftext|><|endoftext|><|endoftext|><|endoftext|><|endoftext|><|endoftext|><|endoftext|><|endoftext|><|endoftext|><|endoftext|><|endoftext|><|endoftext|><|endoftext	'θəː.tɪ.'wɑn.'tɛ.'nɛn.dəʊf.`tɛk.'stɛn.dəʊf.`tɛk.'stɛn.dəʊf.`tɛk.'stɛn.dəʊf.`tɛk.'stɛn.dəʊf.`tɛk.'stɛn.dəʊf.`tɛk.'stɛn.dəʊf.`tɛk.'stɛn.dəʊf.`tɛk.'stɛn.dəʊf.`tɛk.'stɛn.dəʊf.`tɛk.'stɛn.dəʊf.`tɛk.'stɛn.dəʊf.`tɛk.'stɛn.dəʊf.`tɛkst
wickedest	'wɪ.kɛ.dʌst
thou'rt	'ðaʊ.'bæk.slæ.`ʃɑ.'ti
werest	'wəː.sʌnt
m'est	'ɛm.'bæk.slæ.`ʃi.`ɛ.'sti
do?<|endoftext|><|endoftext|><|endoftext|><|endoftext|><|endoftext|><|endoftext|><|endoftext|><|endoftext|><|endoftext|><|endoftext|><|endoftext|><|endoftext|><|endoftext	'dʉː.'ɛn.dəʊf.`tɛk.'stɛn.dəʊf.`tɛk.'stɛn.dəʊf.`tɛk.'stɛn.dəʊf.`tɛk.'stɛn.dəʊf.`tɛk.'stɛn.dəʊf.`tɛk.'stɛn.dəʊf.`tɛk.'stɛn.dəʊf.`tɛk.'stɛn.dəʊf.`tɛk.'stɛn.dəʊf.`tɛk.'stɛn.dəʊf.`tɛk.'stɛn.dəʊf.`tɛk.'stɛn.dəʊf.`tɛkst
morn	'mɔːn
mine—mine	'maɪn.'maɪn
findst	'faɪndst
mine—you	'maɪn.jʉː
l'empere	'ɛl.'bæk.slæ.'ʃɛm.pəː
g-hm	'dʒi.`eɪ.'tʃɛm
no—i'll	'nəʊ.aɪ.'bæk.slæ.`ʃɛ.'lɛl
don—not	'dɑn.'nɑt
matter--i	'mæ.tʌ.'aɪ
habib's	'hæ.bɪb.'bæk.slæ.'ʃɛs
faultless	'fɑlt.lʌs
fault—but	'fɑlt.`bʌt
vai	'vaɪ
said:(they	'sɛd.'ðeɪ
said:(i	'sɛ.'daɪ
wrong—the	'ɹɑŋ.ðʌ
50]hence	'fɪf.tɪ.'hɛns
said...i...did	'sɛ.'daɪ.'dɪd
2)--so	'tʉː.'səʊ
wind-speaks	'wɪnd.'spiks
heart.<|endoftext|><|endoftext|><|endoftext|><|endoftext|><|endoftext|><|endoftext|><|endoftext|><|endoftext|><|endoftext	'hɑ.'tɛn.dəʊf.`tɛk.'stɛn.dəʊf.`tɛk.'stɛn.dəʊf.`tɛk.'stɛn.dəʊf.`tɛk.'stɛn.dəʊf.`tɛk.'stɛn.dəʊf.`tɛk.'stɛn.dəʊf.`tɛk.'stɛn.dəʊf.`tɛk.'stɛn.dəʊf.`tɛkst
faultiest	'fɑl.tɪ.ʌst
thee,for	'ði.fɔː
turnest	'təː.nʌst
evil-will	'i.vʌl.'wɪl
girdest	'ɡəː.dʌst
b-8	'bi.'eɪt
a.-w	'eɪ.'dʌ.bʌl.`jʉː
transgressors	tɹæns.'ɡɹɛ.sʌz
well-meaning	'wɛl.'mi.nɪŋ
offence	ʌ.'fɛns
neighbours	'neɪ.bʌz
11th	ɪ.'lɛ.vʌnθ
good-by-doing	'ɡʊəd.baɪ.'dʉː.ɪŋ
simpleton	'sɪm.pʌl.tʌn
uncleanness	ʌn.'klin.nʌs
will.<|endoftext|><|endoftext|><|endoftext|><|endoftext|><|endoftext|><|endoftext|><|endoftext|><|endoftext|><|endoftext|><|endoftext|><|endoftext|><|endoftext|><|endoftext|><|endoftext	'wɪ.'lɛn.dəʊf.`tɛk.'stɛn.dəʊf.`tɛk.'stɛn.dəʊf.`tɛk.'stɛn.dəʊf.`tɛk.'stɛn.dəʊf.`tɛk.'stɛn.dəʊf.`tɛk.'stɛn.dəʊf.`tɛk.'stɛn.dəʊf.`tɛk.'stɛn.dəʊf.`tɛk.'stɛn.dəʊf.`tɛk.'stɛn.dəʊf.`tɛk.'stɛn.dəʊf.`tɛk.'stɛn.dəʊf.`tɛk.'stɛn.dəʊf.`tɛkst
fellow-in-law	'fɛ.ləʊ.ɪn.'lɔː
fellow-brother	'fɛ.ləʊ.'bɹʌ.ðʌ
mineself	maɪn.'sɛlf
nd	`ɛn.'di
said:...i	'sɛd.'kəʊ.lʌ.'naɪ
ut	'ʌt
owards	'əʊ.ʌdz
areth	'ɑ.ɹʌθ
forgiveest	fʌ.'ɡɪ.vist
lord.<|endoftext|><|endoftext|><|endoftext|><|endoftext|><|endoftext|><|endoftext|><|endoftext|><|endoftext|><|endoftext|><|endoftext	'lɔː.'dɛn.dəʊf.`tɛk.'stɛn.dəʊf.`tɛk.'stɛn.dəʊf.`tɛk.'stɛn.dəʊf.`tɛk.'stɛn.dəʊf.`tɛk.'stɛn.dəʊf.`tɛk.'stɛn.dəʊf.`tɛk.'stɛn.dəʊf.`tɛk.'stɛn.dəʊf.`tɛk.'stɛn.dəʊf.`tɛkst
heart-sorrow	'hɑt.'sɑ.ɹəʊ
heaven-begotten	'hɛ.vʌn.bɪ.'ɡɑ.tʌn
bandon	'bæn.dʌn
3:16...and	'θɹi.'sɪk.sti.'nænd
herefore	'hɛ.ɹɪ.`fɔː
ehold	'i.həʊld
love-beasts	'lʌv.'bists
takest	'teɪ.kʌst
say:...the	'seɪ.'kəʊ.lʌn.'ðʌ
deut	'djʉːt
whereof	'wəː.ɹɑf
odeh	'əʊ.deɪ
wronging	'ɹɑŋ.ɪŋ
xxiii	`ɹəʊ.mʌn.'twɛn.tɪ.'θɹi
wrongers	'ɹɑŋ.ɡʌz
unchastished.—2	ʌn.'tʃæ.stɪʃt.'tʉː
3for	'θɹi.fɔː
wrongned	'ɹɑŋəːnd
btw	`bi.`ti.'dʌ.bʌl.`jʉː
wrongely	'ɹɑndʒ.lɪ
2:13	'tʉː.'θəː.tin
minn	'mɪn
glad.<|endoftext|><|endoftext|><|endoftext|><|endoftext|><|endoftext|><|endoftext|><|endoftext|><|endoftext|><|endoftext	'ɡlæ.'dɛn.dəʊf.`tɛk.'stɛn.dəʊf.`tɛk.'stɛn.dəʊf.`tɛk.'stɛn.dəʊf.`tɛk.'stɛn.dəʊf.`tɛk.'stɛn.dəʊf.`tɛk.'stɛn.dəʊf.`tɛk.'stɛn.dəʊf.`tɛk.'stɛn.dəʊf.`tɛkst
reproved	ɹɪ.'pɹʉːvd
fellow-creature	'fɛ.ləʊ.'kɹi.tʃʌ
expiated	ɛk.spɪ.'eɪ.tɪd
kingdom).<|endoftext|><|endoftext|><|endoftext|><|endoftext|><|endoftext|><|endoftext|><|endoftext|><|endoftext|><|endoftext|><|endoftext|><|endoftext|><|endoftext	'kɪŋ.dʌ.'mɛn.dəʊf.`tɛk.'stɛn.dəʊf.`tɛk.'stɛn.dəʊf.`tɛk.'stɛn.dəʊf.`tɛk.'stɛn.dəʊf.`tɛk.'stɛn.dəʊf.`tɛk.'stɛn.dəʊf.`tɛk.'stɛn.dəʊf.`tɛk.'stɛn.dəʊf.`tɛk.'stɛn.dəʊf.`tɛk.'stɛn.dəʊf.`tɛk.'stɛn.dəʊf.`tɛkst
departest	dɪ.'pɑ.tʌst
wrong-doings	'ɹɑŋ.'dʉː.ɪŋz
3:27-28	'θɹi.'twɛn.tɪ.'sɛ.vʌn.'dæʃ.'twɛn.tɪ.'eɪt
iliot	'ɪ.lɪ.ʌt
23b.14-17	'twɛn.tɪ.'θɹi.'bi.dɑ.'twɑn.'fɔː.'dæʃ.'sɛ.vʌn.`tin
needest	'ni.dʌst
ehelelet	'ɛ.hɪ.`lɛ.lʌt
quran	kwʌ.'ɹæn
thee's	`ði.'bæk.slæ.'ʃɛs
59:5)"the	'fɪf.tɪ.'naɪn.'kəʊ.lʌn.'faɪv.'bæk.slæʃ.ðʌ
fault--as	'fɑl.tæz
a-dee	'eɪ.'di
therefrom	ðəː.'fɹɑm
dio	'di.əʊ
beleiveth	bɪ.'li.vʌθ
m-mamma	'ɛm.'mæ.mʌ
fault--my	'fɑlt.'maɪ
fault!--my	'fɑl.'tɛk.sklʌ.`meɪ.ʃʌn.'maɪ
sins.<|endoftext|><|endoftext|><|endoftext|><|endoftext|><|endoftext|><|endoftext|><|endoftext|><|endoftext|><|endoftext|><|endoftext|><|endoftext	'sɪn.'zɛn.dəʊf.`tɛk.'stɛn.dəʊf.`tɛk.'stɛn.dəʊf.`tɛk.'stɛn.dəʊf.`tɛk.'stɛn.dəʊf.`tɛk.'stɛn.dəʊf.`tɛk.'stɛn.dəʊf.`tɛk.'stɛn.dəʊf.`tɛk.'stɛn.dəʊf.`tɛk.'stɛn.dəʊf.`tɛk.'stɛn.dəʊf.`tɛkst
sick—and	'sɪ.kænd
me.<|endoftext|><|endoftext|><|endoftext|><|endoftext|><|endoftext|><|endoftext|><|endoftext|><|endoftext	'mi.'ɛn.dəʊf.`tɛk.'stɛn.dəʊf.`tɛk.'stɛn.dəʊf.`tɛk.'stɛn.dəʊf.`tɛk.'stɛn.dəʊf.`tɛk.'stɛn.dəʊf.`tɛk.'stɛn.dəʊf.`tɛk.'stɛn.dəʊf.`tɛkst
fault's	'fɑlt.'bæk.slæ.'ʃɛs
good-for-nothing	'ɡʊəd.fɔː.'nʌ.θɪŋ
own...but	'əʊn.'bʌt
war-devils	'wɔː.'dɛ.vʌlz
beliest	bɪ.'lɪst
korak	'kɔː.ɹæk
straight-minded	'stɹeɪt.'maɪn.dɪd
so—they	'səʊ.ðeɪ
god—yet	'ɡɑd.'jɛt
his.<|endoftext|><|endoftext|><|endoftext|><|endoftext|><|endoftext|><|endoftext|><|endoftext	'hɪ.'zɛn.dəʊf.`tɛk.'stɛn.dəʊf.`tɛk.'stɛn.dəʊf.`tɛk.'stɛn.dəʊf.`tɛk.'stɛn.dəʊf.`tɛk.'stɛn.dəʊf.`tɛk.'stɛn.dəʊf.`tɛkst
9]the	'naɪn.ðʌ
blesseth	'blɛ.sʌθ
god-lord	'ɡɑd.'lɔːd
young!—but	'jʌŋ.'bʌt
it.<|endoftext|><|endoftext|><|endoftext|><|endoftext|><|endoftext|><|endoftext|><|endoftext|><|endoftext|><|endoftext|><|endoftext|><|endoftext|><|endoftext	'ɪ.'tɛn.dəʊf.`tɛk.'stɛn.dəʊf.`tɛk.'stɛn.dəʊf.`tɛk.'stɛn.dəʊf.`tɛk.'stɛn.dəʊf.`tɛk.'stɛn.dəʊf.`tɛk.'stɛn.dəʊf.`tɛk.'stɛn.dəʊf.`tɛk.'stɛn.dəʊf.`tɛk.'stɛn.dəʊf.`tɛk.'stɛn.dəʊf.`tɛk.'stɛn.dəʊf.`tɛkst
night.<|endoftext|><|endoftext|><|endoftext|><|endoftext|><|endoftext|><|endoftext|><|endoftext|><|endoftext	'naɪ.'tɛn.dəʊf.`tɛk.'stɛn.dəʊf.`tɛk.'stɛn.dəʊf.`tɛk.'stɛn.dəʊf.`tɛk.'stɛn.dəʊf.`tɛk.'stɛn.dəʊf.`tɛk.'stɛn.dəʊf.`tɛk.'stɛn.dəʊf.`tɛkst
master.<|endoftext|><|endoftext|><|endoftext|><|endoftext|><|endoftext|><|endoftext|><|endoftext|><|endoftext|><|endoftext|><|endoftext|><|endoftext|><|endoftext|><|endoftext|><|endoftext|><|endoftext	'mæ.stʌ.'ɛn.dəʊf.`tɛk.'stɛn.dəʊf.`tɛk.'stɛn.dəʊf.`tɛk.'stɛn.dəʊf.`tɛk.'stɛn.dəʊf.`tɛk.'stɛn.dəʊf.`tɛk.'stɛn.dəʊf.`tɛk.'stɛn.dəʊf.`tɛk.'stɛn.dəʊf.`tɛk.'stɛn.dəʊf.`tɛk.'stɛn.dəʊf.`tɛk.'stɛn.dəʊf.`tɛk.'stɛn.dəʊf.`tɛk.'stɛn.dəʊf.`tɛk.'stɛn.dəʊf.`tɛkst
right-hand	'ɹaɪt.'hænd
thou'llest	'ðaʊ.'bæk.slæʃ.'lɛst
amen.<|endoftext|><|endoftext|><|endoftext|><|endoftext|><|endoftext|><|endoftext|><|endoftext|><|endoftext|><|endoftext	`ɑ.'mɛ.'nɛn.dəʊf.`tɛk.'stɛn.dəʊf.`tɛk.'stɛn.dəʊf.`tɛk.'stɛn.dəʊf.`tɛk.'stɛn.dəʊf.`tɛk.'stɛn.dəʊf.`tɛk.'stɛn.dəʊf.`tɛk.'stɛn.dəʊf.`tɛk.'stɛn.dəʊf.`tɛkst
bed.<|endoftext|><|endoftext|><|endoftext|><|endoftext|><|endoftext|><|endoftext|><|endoftext|><|endoftext|><|endoftext|><|endoftext|><|endoftext|><|endoftext|><|endoftext|><|endoftext	'bɛ.'dɛn.dəʊf.`tɛk.'stɛn.dəʊf.`tɛk.'stɛn.dəʊf.`tɛk.'stɛn.dəʊf.`tɛk.'stɛn.dəʊf.`tɛk.'stɛn.dəʊf.`tɛk.'stɛn.dəʊf.`tɛk.'stɛn.dəʊf.`tɛk.'stɛn.dəʊf.`tɛk.'stɛn.dəʊf.`tɛk.'stɛn.dəʊf.`tɛk.'stɛn.dəʊf.`tɛk.'stɛn.dəʊf.`tɛk.'stɛn.dəʊf.`tɛkst
done.<|endoftext|><|endoftext|><|endoftext|><|endoftext|><|endoftext|><|endoftext|><|endoftext|><|endoftext|><|endoftext|><|endoftext|><|endoftext|><|endoftext|><|endoftext|><|endoftext|><|endoftext|><|endoftext	'dʌ.'nɛn.dəʊf.`tɛk.'stɛn.dəʊf.`tɛk.'stɛn.dəʊf.`tɛk.'stɛn.dəʊf.`tɛk.'stɛn.dəʊf.`tɛk.'stɛn.dəʊf.`tɛk.'stɛn.dəʊf.`tɛk.'stɛn.dəʊf.`tɛk.'stɛn.dəʊf.`tɛk.'stɛn.dəʊf.`tɛk.'stɛn.dəʊf.`tɛk.'stɛn.dəʊf.`tɛk.'stɛn.dəʊf.`tɛk.'stɛn.dəʊf.`tɛk.'stɛn.dəʊf.`tɛk.'stɛn.dəʊf.`tɛkst
dwelling-place.<|endoftext|><|endoftext|><|endoftext|><|endoftext|><|endoftext|><|endoftext|><|endoftext|><|endoftext|><|endoftext|><|endoftext|><|endoftext	'dwɛ.lɪŋ.'pleɪ.'sɛn.dəʊf.`tɛk.'stɛn.dəʊf.`tɛk.'stɛn.dəʊf.`tɛk.'stɛn.dəʊf.`tɛk.'stɛn.dəʊf.`tɛk.'stɛn.dəʊf.`tɛk.'stɛn.dəʊf.`tɛk.'stɛn.dəʊf.`tɛk.'stɛn.dəʊf.`tɛk.'stɛn.dəʊf.`tɛk.'stɛn.dəʊf.`tɛkst
restth	'ɹɛstθ
old-fashioned	'əʊld.'fæ.ʃʌnd
ways.<|endoftext|><|endoftext|><|endoftext|><|endoftext|><|endoftext|><|endoftext|><|endoftext|><|endoftext|><|endoftext|><|endoftext|><|endoftext|><|endoftext|><|endoftext|><|endoftext|><|endoftext|><|endoftext	'weɪ.'zɛn.dəʊf.`tɛk.'stɛn.dəʊf.`tɛk.'stɛn.dəʊf.`tɛk.'stɛn.dəʊf.`tɛk.'stɛn.dəʊf.`tɛk.'stɛn.dəʊf.`tɛk.'stɛn.dəʊf.`tɛk.'stɛn.dəʊf.`tɛk.'stɛn.dəʊf.`tɛk.'stɛn.dəʊf.`tɛk.'stɛn.dəʊf.`tɛk.'stɛn.dəʊf.`tɛk.'stɛn.dəʊf.`tɛk.'stɛn.dəʊf.`tɛk.'stɛn.dəʊf.`tɛk.'stɛn.dəʊf.`tɛkst
way.<|endoftext|><|endoftext|><|endoftext|><|endoftext|><|endoftext|><|endoftext|><|endoftext|><|endoftext|><|endoftext|><|endoftext	'weɪ.'ɛn.dəʊf.`tɛk.'stɛn.dəʊf.`tɛk.'stɛn.dəʊf.`tɛk.'stɛn.dəʊf.`tɛk.'stɛn.dəʊf.`tɛk.'stɛn.dəʊf.`tɛk.'stɛn.dəʊf.`tɛk.'stɛn.dəʊf.`tɛk.'stɛn.dəʊf.`tɛk.'stɛn.dəʊf.`tɛkst
returnest	ɹɪ.'təː.nʌst
lord.<|endoftext|><|endoftext|><|endoftext|><|endoftext|><|endoftext|><|endoftext|><|endoftext|><|endoftext|><|endoftext|><|endoftext|><|endoftext|><|endoftext|><|endoftext|><|endoftext|><|endoftext|><|endoftext	'lɔː.'dɛn.dəʊf.`tɛk.'stɛn.dəʊf.`tɛk.'stɛn.dəʊf.`tɛk.'stɛn.dəʊf.`tɛk.'stɛn.dəʊf.`tɛk.'stɛn.dəʊf.`tɛk.'stɛn.dəʊf.`tɛk.'stɛn.dəʊf.`tɛk.'stɛn.dəʊf.`tɛk.'stɛn.dəʊf.`tɛk.'stɛn.dəʊf.`tɛk.'stɛn.dəʊf.`tɛk.'stɛn.dəʊf.`tɛk.'stɛn.dəʊf.`tɛk.'stɛn.dəʊf.`tɛk.'stɛn.dəʊf.`tɛkst
first-century	'fəːst.'sɛn.tʃʌ.ɹɪ
thou.<|endoftext|><|endoftext|><|endoftext|><|endoftext|><|endoftext|><|endoftext|><|endoftext|><|endoftext|><|endoftext|><|endoftext|><|endoftext|><|endoftext|><|endoftext|><|endoftext|><|endoftext|><|endoftext	'ðaʊ.'ɛn.dəʊf.`tɛk.'stɛn.dəʊf.`tɛk.'stɛn.dəʊf.`tɛk.'stɛn.dəʊf.`tɛk.'stɛn.dəʊf.`tɛk.'stɛn.dəʊf.`tɛk.'stɛn.dəʊf.`tɛk.'stɛn.dəʊf.`tɛk.'stɛn.dəʊf.`tɛk.'stɛn.dəʊf.`tɛk.'stɛn.dəʊf.`tɛk.'stɛn.dəʊf.`tɛk.'stɛn.dəʊf.`tɛk.'stɛn.dəʊf.`tɛk.'stɛn.dəʊf.`tɛk.'stɛn.dəʊf.`tɛkst
mighty-hearted	'maɪ.tɪ.'hɑ.tɪd
thee.and	`ði.'dɑ.tænd
right.<|endoftext|><|endoftext|><|endoftext|><|endoftext|><|endoftext|><|endoftext|><|endoftext|><|endoftext|><|endoftext|><|endoftext|><|endoftext|><|endoftext	'ɹaɪ.'tɛn.dəʊf.`tɛk.'stɛn.dəʊf.`tɛk.'stɛn.dəʊf.`tɛk.'stɛn.dəʊf.`tɛk.'stɛn.dəʊf.`tɛk.'stɛn.dəʊf.`tɛk.'stɛn.dəʊf.`tɛk.'stɛn.dəʊf.`tɛk.'stɛn.dəʊf.`tɛk.'stɛn.dəʊf.`tɛk.'stɛn.dəʊf.`tɛk.'stɛn.dəʊf.`tɛkst
done.<|endoftext|><|endoftext|><|endoftext|><|endoftext|><|endoftext|><|endoftext|><|endoftext|><|endoftext|><|endoftext|><|endoftext|><|endoftext|><|endoftext|><|endoftext	'dʌ.'nɛn.dəʊf.`tɛk.'stɛn.dəʊf.`tɛk.'stɛn.dəʊf.`tɛk.'stɛn.dəʊf.`tɛk.'stɛn.dəʊf.`tɛk.'stɛn.dəʊf.`tɛk.'stɛn.dəʊf.`tɛk.'stɛn.dəʊf.`tɛk.'stɛn.dəʊf.`tɛk.'stɛn.dəʊf.`tɛk.'stɛn.dəʊf.`tɛk.'stɛn.dəʊf.`tɛk.'stɛn.dəʊf.`tɛkst
home.<|endoftext|><|endoftext|><|endoftext|><|endoftext|><|endoftext|><|endoftext|><|endoftext|><|endoftext|><|endoftext|><|endoftext|><|endoftext	'həʊ.'mɛn.dəʊf.`tɛk.'stɛn.dəʊf.`tɛk.'stɛn.dəʊf.`tɛk.'stɛn.dəʊf.`tɛk.'stɛn.dəʊf.`tɛk.'stɛn.dəʊf.`tɛk.'stɛn.dəʊf.`tɛk.'stɛn.dəʊf.`tɛk.'stɛn.dəʊf.`tɛk.'stɛn.dəʊf.`tɛk.'stɛn.dəʊf.`tɛkst
come.<|endoftext|><|endoftext|><|endoftext|><|endoftext|><|endoftext|><|endoftext|><|endoftext|><|endoftext|><|endoftext|><|endoftext|><|endoftext	'kʌ.'mɛn.dəʊf.`tɛk.'stɛn.dəʊf.`tɛk.'stɛn.dəʊf.`tɛk.'stɛn.dəʊf.`tɛk.'stɛn.dəʊf.`tɛk.'stɛn.dəʊf.`tɛk.'stɛn.dəʊf.`tɛk.'stɛn.dəʊf.`tɛk.'stɛn.dəʊf.`tɛk.'stɛn.dəʊf.`tɛk.'stɛn.dəʊf.`tɛkst
sitest	'saɪ.tʌst
rested.<|endoftext|><|endoftext|><|endoftext|><|endoftext|><|endoftext|><|endoftext|><|endoftext|><|endoftext|><|endoftext|><|endoftext|><|endoftext|><|endoftext|><|endoftext|><|endoftext|><|endoftext|><|endoftext	'ɹɛ.stɪ.'dɛn.dəʊf.`tɛk.'stɛn.dəʊf.`tɛk.'stɛn.dəʊf.`tɛk.'stɛn.dəʊf.`tɛk.'stɛn.dəʊf.`tɛk.'stɛn.dəʊf.`tɛk.'stɛn.dəʊf.`tɛk.'stɛn.dəʊf.`tɛk.'stɛn.dəʊf.`tɛk.'stɛn.dəʊf.`tɛk.'stɛn.dəʊf.`tɛk.'stɛn.dəʊf.`tɛk.'stɛn.dəʊf.`tɛk.'stɛn.dəʊf.`tɛk.'stɛn.dəʊf.`tɛk.'stɛn.dəʊf.`tɛkst
resting.and	'ɹɛ.stɪŋ.'dɑ.tænd
ready.<|endoftext|><|endoftext|><|endoftext|><|endoftext|><|endoftext|><|endoftext|><|endoftext|><|endoftext|><|endoftext|><|endoftext|><|endoftext|><|endoftext	'ɹɛ.dɪ.'ɛn.dəʊf.`tɛk.'stɛn.dəʊf.`tɛk.'stɛn.dəʊf.`tɛk.'stɛn.dəʊf.`tɛk.'stɛn.dəʊf.`tɛk.'stɛn.dəʊf.`tɛk.'stɛn.dəʊf.`tɛk.'stɛn.dəʊf.`tɛk.'stɛn.dəʊf.`tɛk.'stɛn.dəʊf.`tɛk.'stɛn.dəʊf.`tɛk.'stɛn.dəʊf.`tɛkst
thee.<|endoftext|><|endoftext|><|endoftext|><|endoftext|><|endoftext|><|endoftext|><|endoftext|><|endoftext	'ði.'ɛn.dəʊf.`tɛk.'stɛn.dəʊf.`tɛk.'stɛn.dəʊf.`tɛk.'stɛn.dəʊf.`tɛk.'stɛn.dəʊf.`tɛk.'stɛn.dəʊf.`tɛk.'stɛn.dəʊf.`tɛk.'stɛn.dəʊf.`tɛkst
last-day	'læst.'deɪ
al-qayyim	'æl.'keɪ.jɪm
1777-2006	'wɑn.'θaʊ.zʌnd.'sɛ.vʌn.'hʌn.dɹʌ.dʌn.'sɛ.vʌn.tɪ.'sɛ.vʌn.'dæʃ.'tʉː.'θaʊ.zʌn.dʌn.'sɪks
c.<|endoftext|><|endoftext|><|endoftext|><|endoftext|><|endoftext|><|endoftext	'si.'ɛn.dəʊf.`tɛk.'stɛn.dəʊf.`tɛk.'stɛn.dəʊf.`tɛk.'stɛn.dəʊf.`tɛk.'stɛn.dəʊf.`tɛk.'stɛn.dəʊf.`tɛkst
comes.<|endoftext|><|endoftext|><|endoftext|><|endoftext|><|endoftext|><|endoftext|><|endoftext|><|endoftext|><|endoftext|><|endoftext|><|endoftext|><|endoftext|><|endoftext|><|endoftext|><|endoftext	'kʌm.'zɛn.dəʊf.`tɛk.'stɛn.dəʊf.`tɛk.'stɛn.dəʊf.`tɛk.'stɛn.dəʊf.`tɛk.'stɛn.dəʊf.`tɛk.'stɛn.dəʊf.`tɛk.'stɛn.dəʊf.`tɛk.'stɛn.dəʊf.`tɛk.'stɛn.dəʊf.`tɛk.'stɛn.dəʊf.`tɛk.'stɛn.dəʊf.`tɛk.'stɛn.dəʊf.`tɛk.'stɛn.dəʊf.`tɛk.'stɛn.dəʊf.`tɛk.'stɛn.dəʊf.`tɛkst
dead.<|endoftext|><|endoftext|><|endoftext|><|endoftext|><|endoftext|><|endoftext|><|endoftext|><|endoftext	'dɛ.'dɛn.dəʊf.`tɛk.'stɛn.dəʊf.`tɛk.'stɛn.dəʊf.`tɛk.'stɛn.dəʊf.`tɛk.'stɛn.dəʊf.`tɛk.'stɛn.dəʊf.`tɛk.'stɛn.dəʊf.`tɛk.'stɛn.dəʊf.`tɛkst
xv	`ɹəʊ.mʌn.'fɪf.tin
resteth	'ɹɛ.stʌθ
way.<|endoftext|><|endoftext|><|endoftext|><|endoftext|><|endoftext|><|endoftext|><|endoftext|><|endoftext|><|endoftext|><|endoftext|><|endoftext	'weɪ.'ɛn.dəʊf.`tɛk.'stɛn.dəʊf.`tɛk.'stɛn.dəʊf.`tɛk.'stɛn.dəʊf.`tɛk.'stɛn.dəʊf.`tɛk.'stɛn.dəʊf.`tɛk.'stɛn.dəʊf.`tɛk.'stɛn.dəʊf.`tɛk.'stɛn.dəʊf.`tɛk.'stɛn.dəʊf.`tɛk.'stɛn.dəʊf.`tɛkst
god.<|endoftext|><|endoftext|><|endoftext|><|endoftext|><|endoftext|><|endoftext|><|endoftext|><|endoftext|><|endoftext|><|endoftext|><|endoftext|><|endoftext|><|endoftext	'ɡɑ.'dɛn.dəʊf.`tɛk.'stɛn.dəʊf.`tɛk.'stɛn.dəʊf.`tɛk.'stɛn.dəʊf.`tɛk.'stɛn.dəʊf.`tɛk.'stɛn.dəʊf.`tɛk.'stɛn.dəʊf.`tɛk.'stɛn.dəʊf.`tɛk.'stɛn.dəʊf.`tɛk.'stɛn.dəʊf.`tɛk.'stɛn.dəʊf.`tɛk.'stɛn.dəʊf.`tɛk.'stɛn.dəʊf.`tɛkst
breeze.<|endoftext|><|endoftext|><|endoftext|><|endoftext|><|endoftext|><|endoftext|><|endoftext|><|endoftext|><|endoftext|><|endoftext|><|endoftext|><|endoftext|><|endoftext|><|endoftext|><|endoftext|><|endoftext	'bɹi.'zɛn.dəʊf.`tɛk.'stɛn.dəʊf.`tɛk.'stɛn.dəʊf.`tɛk.'stɛn.dəʊf.`tɛk.'stɛn.dəʊf.`tɛk.'stɛn.dəʊf.`tɛk.'stɛn.dəʊf.`tɛk.'stɛn.dəʊf.`tɛk.'stɛn.dəʊf.`tɛk.'stɛn.dəʊf.`tɛk.'stɛn.dəʊf.`tɛk.'stɛn.dəʊf.`tɛk.'stɛn.dəʊf.`tɛk.'stɛn.dəʊf.`tɛk.'stɛn.dəʊf.`tɛk.'stɛn.dəʊf.`tɛkst
peace.<|endoftext|><|endoftext|><|endoftext|><|endoftext|><|endoftext|><|endoftext|><|endoftext|><|endoftext|><|endoftext|><|endoftext|><|endoftext|><|endoftext|><|endoftext	'pi.'sɛn.dəʊf.`tɛk.'stɛn.dəʊf.`tɛk.'stɛn.dəʊf.`tɛk.'stɛn.dəʊf.`tɛk.'stɛn.dəʊf.`tɛk.'stɛn.dəʊf.`tɛk.'stɛn.dəʊf.`tɛk.'stɛn.dəʊf.`tɛk.'stɛn.dəʊf.`tɛk.'stɛn.dəʊf.`tɛk.'stɛn.dəʊf.`tɛk.'stɛn.dəʊf.`tɛk.'stɛn.dəʊf.`tɛkst
laid.<|endoftext|><|endoftext|><|endoftext|><|endoftext|><|endoftext|><|endoftext|><|endoftext|><|endoftext|><|endoftext|><|endoftext|><|endoftext|><|endoftext|><|endoftext|><|endoftext|><|endoftext	'leɪ.'dɛn.dəʊf.`tɛk.'stɛn.dəʊf.`tɛk.'stɛn.dəʊf.`tɛk.'stɛn.dəʊf.`tɛk.'stɛn.dəʊf.`tɛk.'stɛn.dəʊf.`tɛk.'stɛn.dəʊf.`tɛk.'stɛn.dəʊf.`tɛk.'stɛn.dəʊf.`tɛk.'stɛn.dəʊf.`tɛk.'stɛn.dəʊf.`tɛk.'stɛn.dəʊf.`tɛk.'stɛn.dəʊf.`tɛk.'stɛn.dəʊf.`tɛk.'stɛn.dəʊf.`tɛkst
ways."<|endoftext|><|endoftext|><|endoftext|><|endoftext|><|endoftext|><|endoftext|><|endoftext|><|endoftext|><|endoftext|><|endoftext|><|endoftext|><|endoftext|><|endoftext|><|endoftext	'weɪz.'dɑt.bʌk.`slæ.'ʃɛn.dəʊf.`tɛk.'stɛn.dəʊf.`tɛk.'stɛn.dəʊf.`tɛk.'stɛn.dəʊf.`tɛk.'stɛn.dəʊf.`tɛk.'stɛn.dəʊf.`tɛk.'stɛn.dəʊf.`tɛk.'stɛn.dəʊf.`tɛk.'stɛn.dəʊf.`tɛk.'stɛn.dəʊf.`tɛk.'stɛn.dəʊf.`tɛk.'stɛn.dəʊf.`tɛk.'stɛn.dəʊf.`tɛk.'stɛn.dəʊf.`tɛkst
holies	'həʊ.lɪz
p1:14	'pi.'wɑn.'fɔː.tin
mustest	'mʌ.stʌst
serve.<|endoftext|><|endoftext|><|endoftext|><|endoftext|><|endoftext|><|endoftext|><|endoftext|><|endoftext|><|endoftext|><|endoftext|><|endoftext|><|endoftext|><|endoftext	'səː.'vɛn.dəʊf.`tɛk.'stɛn.dəʊf.`tɛk.'stɛn.dəʊf.`tɛk.'stɛn.dəʊf.`tɛk.'stɛn.dəʊf.`tɛk.'stɛn.dəʊf.`tɛk.'stɛn.dəʊf.`tɛk.'stɛn.dəʊf.`tɛk.'stɛn.dəʊf.`tɛk.'stɛn.dəʊf.`tɛk.'stɛn.dəʊf.`tɛk.'stɛn.dəʊf.`tɛk.'stɛn.dəʊf.`tɛkst
kill.<|endoftext|><|endoftext|><|endoftext|><|endoftext|><|endoftext|><|endoftext|><|endoftext|><|endoftext|><|endoftext|><|endoftext|><|endoftext|><|endoftext|><|endoftext	'kɪ.'lɛn.dəʊf.`tɛk.'stɛn.dəʊf.`tɛk.'stɛn.dəʊf.`tɛk.'stɛn.dəʊf.`tɛk.'stɛn.dəʊf.`tɛk.'stɛn.dəʊf.`tɛk.'stɛn.dəʊf.`tɛk.'stɛn.dəʊf.`tɛk.'stɛn.dəʊf.`tɛk.'stɛn.dəʊf.`tɛk.'stɛn.dəʊf.`tɛk.'stɛn.dəʊf.`tɛk.'stɛn.dəʊf.`tɛkst
summer.and	'sʌ.mʌ.'dɑ.tænd
die.<|endoftext|><|endoftext|><|endoftext|><|endoftext|><|endoftext|><|endoftext|><|endoftext|><|endoftext|><|endoftext|><|endoftext|><|endoftext|><|endoftext|><|endoftext|><|endoftext|><|endoftext	'daɪ.'ɛn.dəʊf.`tɛk.'stɛn.dəʊf.`tɛk.'stɛn.dəʊf.`tɛk.'stɛn.dəʊf.`tɛk.'stɛn.dəʊf.`tɛk.'stɛn.dəʊf.`tɛk.'stɛn.dəʊf.`tɛk.'stɛn.dəʊf.`tɛk.'stɛn.dəʊf.`tɛk.'stɛn.dəʊf.`tɛk.'stɛn.dəʊf.`tɛk.'stɛn.dəʊf.`tɛk.'stɛn.dəʊf.`tɛk.'stɛn.dəʊf.`tɛk.'stɛn.dəʊf.`tɛkst
day.<|endoftext|><|endoftext|><|endoftext|><|endoftext|><|endoftext|><|endoftext|><|endoftext|><|endoftext|><|endoftext|><|endoftext|><|endoftext|><|endoftext|><|endoftext|><|endoftext|><|endoftext|><|endoftext	'deɪ.'ɛn.dəʊf.`tɛk.'stɛn.dəʊf.`tɛk.'stɛn.dəʊf.`tɛk.'stɛn.dəʊf.`tɛk.'stɛn.dəʊf.`tɛk.'stɛn.dəʊf.`tɛk.'stɛn.dəʊf.`tɛk.'stɛn.dəʊf.`tɛk.'stɛn.dəʊf.`tɛk.'stɛn.dəʊf.`tɛk.'stɛn.dəʊf.`tɛk.'stɛn.dəʊf.`tɛk.'stɛn.dəʊf.`tɛk.'stɛn.dəʊf.`tɛk.'stɛn.dəʊf.`tɛk.'stɛn.dəʊf.`tɛkst
god.<|endoftext|><|endoftext|><|endoftext|><|endoftext|><|endoftext|><|endoftext|><|endoftext|><|endoftext|><|endoftext|><|endoftext|><|endoftext|><|endoftext	'ɡɑ.'dɛn.dəʊf.`tɛk.'stɛn.dəʊf.`tɛk.'stɛn.dəʊf.`tɛk.'stɛn.dəʊf.`tɛk.'stɛn.dəʊf.`tɛk.'stɛn.dəʊf.`tɛk.'stɛn.dəʊf.`tɛk.'stɛn.dəʊf.`tɛk.'stɛn.dəʊf.`tɛk.'stɛn.dəʊf.`tɛk.'stɛn.dəʊf.`tɛk.'stɛn.dəʊf.`tɛkst
doom.<|endoftext|><|endoftext|><|endoftext|><|endoftext|><|endoftext|><|endoftext|><|endoftext|><|endoftext|><|endoftext|><|endoftext|><|endoftext|><|endoftext|><|endoftext|><|endoftext|><|endoftext|><|endoftext|><|endoftext	'dʉː.'mɛn.dəʊf.`tɛk.'stɛn.dəʊf.`tɛk.'stɛn.dəʊf.`tɛk.'stɛn.dəʊf.`tɛk.'stɛn.dəʊf.`tɛk.'stɛn.dəʊf.`tɛk.'stɛn.dəʊf.`tɛk.'stɛn.dəʊf.`tɛk.'stɛn.dəʊf.`tɛk.'stɛn.dəʊf.`tɛk.'stɛn.dəʊf.`tɛk.'stɛn.dəʊf.`tɛk.'stɛn.dəʊf.`tɛk.'stɛn.dəʊf.`tɛk.'stɛn.dəʊf.`tɛk.'stɛn.dəʊf.`tɛk.'stɛn.dəʊf.`tɛkst
38]but	'θəː.tɪ.'eɪt.`bʌt
15—the	'fɪf.tin.ðʌ
cuthbert.—mentioned	'kʌθ.bʌt.'mɛn.ʃʌnd
far.<|endoftext|><|endoftext|><|endoftext|><|endoftext|><|endoftext|><|endoftext|><|endoftext	'fɑ.'ɛn.dəʊf.`tɛk.'stɛn.dəʊf.`tɛk.'stɛn.dəʊf.`tɛk.'stɛn.dəʊf.`tɛk.'stɛn.dəʊf.`tɛk.'stɛn.dəʊf.`tɛk.'stɛn.dəʊf.`tɛkst
tear-stained	'teɪ.ʌ.'steɪnd
old.<|endoftext|><|endoftext|><|endoftext|><|endoftext|><|endoftext|><|endoftext|><|endoftext|><|endoftext|><|endoftext|><|endoftext|><|endoftext|><|endoftext|><|endoftext|><|endoftext|><|endoftext|><|endoftext|><|endoftext	'əʊl.'dɛn.dəʊf.`tɛk.'stɛn.dəʊf.`tɛk.'stɛn.dəʊf.`tɛk.'stɛn.dəʊf.`tɛk.'stɛn.dəʊf.`tɛk.'stɛn.dəʊf.`tɛk.'stɛn.dəʊf.`tɛk.'stɛn.dəʊf.`tɛk.'stɛn.dəʊf.`tɛk.'stɛn.dəʊf.`tɛk.'stɛn.dəʊf.`tɛk.'stɛn.dəʊf.`tɛk.'stɛn.dəʊf.`tɛk.'stɛn.dəʊf.`tɛk.'stɛn.dəʊf.`tɛk.'stɛn.dəʊf.`tɛk.'stɛn.dəʊf.`tɛkst
mantle.<|endoftext|><|endoftext|><|endoftext|><|endoftext|><|endoftext|><|endoftext|><|endoftext|><|endoftext|><|endoftext|><|endoftext|><|endoftext|><|endoftext	'mæn.tʌ.'lɛn.dəʊf.`tɛk.'stɛn.dəʊf.`tɛk.'stɛn.dəʊf.`tɛk.'stɛn.dəʊf.`tɛk.'stɛn.dəʊf.`tɛk.'stɛn.dəʊf.`tɛk.'stɛn.dəʊf.`tɛk.'stɛn.dəʊf.`tɛk.'stɛn.dəʊf.`tɛk.'stɛn.dəʊf.`tɛk.'stɛn.dəʊf.`tɛk.'stɛn.dəʊf.`tɛkst
red-leaf	'ɹɛd.'lif
coarse-looking	'kɔː.'slʊə.kɪŋ
blood-thirsty	'blʌd.'θəː.stɪ
fulham	'fʊə.lʌm
cloth—in	'klɑ.'θɪn
sweet-moss-haired	'swit.'mɑs.'həːd
blood-filled	'blʌd.'fɪld
twenty-two	'twɛn.tɪ.'tʉː
gilded-white	'ɡɪl.dɪ.'dwaɪt
debaca	dʌ.'bæ.kʌ
thereon	ðəː.'ɹɑn
shewing	'ʃəʊ.ɪŋ
red-wool-white	'ɹɛ.'dwʊəl.'waɪt
silver-channels	'sɪl.vʌ.'tʃæ.nʌlz
ganest	'ɡeɪ.nʌst
man.thine	'mæn.'dɑt.`ðaɪn
again.<|endoftext|><|endoftext|><|endoftext|><|endoftext|><|endoftext|><|endoftext|><|endoftext|><|endoftext|><|endoftext|><|endoftext|><|endoftext|><|endoftext|><|endoftext	ʌ.'ɡɛ.'nɛn.dəʊf.`tɛk.'stɛn.dəʊf.`tɛk.'stɛn.dəʊf.`tɛk.'stɛn.dəʊf.`tɛk.'stɛn.dəʊf.`tɛk.'stɛn.dəʊf.`tɛk.'stɛn.dəʊf.`tɛk.'stɛn.dəʊf.`tɛk.'stɛn.dəʊf.`tɛk.'stɛn.dəʊf.`tɛk.'stɛn.dəʊf.`tɛk.'stɛn.dəʊf.`tɛk.'stɛn.dəʊf.`tɛkst
bedstead	'bɛd.stɛd
bedfolds	'bɛd.fəʊldz
none,for	'nʌn.fɔː
gone.<|endoftext|><|endoftext|><|endoftext|><|endoftext|><|endoftext|><|endoftext|><|endoftext	'ɡɑ.'nɛn.dəʊf.`tɛk.'stɛn.dəʊf.`tɛk.'stɛn.dəʊf.`tɛk.'stɛn.dəʊf.`tɛk.'stɛn.dəʊf.`tɛk.'stɛn.dəʊf.`tɛk.'stɛn.dəʊf.`tɛkst
seat.<|endoftext|><|endoftext|><|endoftext|><|endoftext|><|endoftext|><|endoftext|><|endoftext|><|endoftext|><|endoftext|><|endoftext	'si.'tɛn.dəʊf.`tɛk.'stɛn.dəʊf.`tɛk.'stɛn.dəʊf.`tɛk.'stɛn.dəʊf.`tɛk.'stɛn.dəʊf.`tɛk.'stɛn.dəʊf.`tɛk.'stɛn.dəʊf.`tɛk.'stɛn.dəʊf.`tɛk.'stɛn.dəʊf.`tɛk.'stɛn.dəʊf.`tɛkst
days.<|endoftext|><|endoftext|><|endoftext|><|endoftext|><|endoftext|><|endoftext|><|endoftext|><|endoftext|><|endoftext|><|endoftext	'deɪ.'zɛn.dəʊf.`tɛk.'stɛn.dəʊf.`tɛk.'stɛn.dəʊf.`tɛk.'stɛn.dəʊf.`tɛk.'stɛn.dəʊf.`tɛk.'stɛn.dəʊf.`tɛk.'stɛn.dəʊf.`tɛk.'stɛn.dəʊf.`tɛk.'stɛn.dəʊf.`tɛk.'stɛn.dəʊf.`tɛkst
all-sufficient	'ɔːl.sʌ.'fɪ.ʃʌnt
ist	'ɪst
ii.14	'ɹəʊ.mʌ.`nɪ.aɪ.dɑ.'twɑn.'fɔː
trembles	'tɹɛm.bʌlz
sleeping-horse	'sli.pɪŋ.'hɔːs
fallen,o	'fɔː.lʌ.'nəʊ
shalln't	'ʃɔːləːn.'bæk.slæʃ.'ti
fall.<|endoftext|><|endoftext|><|endoftext|><|endoftext|><|endoftext|><|endoftext|><|endoftext|><|endoftext|><|endoftext|><|endoftext|><|endoftext	'fɔː.'lɛn.dəʊf.`tɛk.'stɛn.dəʊf.`tɛk.'stɛn.dəʊf.`tɛk.'stɛn.dəʊf.`tɛk.'stɛn.dəʊf.`tɛk.'stɛn.dəʊf.`tɛk.'stɛn.dəʊf.`tɛk.'stɛn.dəʊf.`tɛk.'stɛn.dəʊf.`tɛk.'stɛn.dəʊf.`tɛk.'stɛn.dəʊf.`tɛkst
shaltn	'ʃæl.tʌn
k'chaik'il	'keɪ.'bæk.slæʃ.'tʃeɪk.'bæk.slæ.'ʃɪl
hourless	'aʊ.ʌ.lʌs
old-time	'əʊld.'taɪm
middle-eastern	'mɪ.dʌ.'li.stʌn
good-looking	'ɡʊəd.'lʊə.kɪŋ
tibboleth	'tɪ.bəʊ.lʌθ
sufferest	'sʌ.fʌ.ɹʌst
gost	'ɡɑst
i.thy	'aɪ.'dɑt.`ðaɪ
not.<|endoftext|><|endoftext|><|endoftext	'nɑ.'tɛn.dəʊf.`tɛk.'stɛn.dəʊf.`tɛk.'stɛn.dəʊf.`tɛkst
ful	'fʌl
fornication	`fɔː.nɪ.'keɪ.ʃʌn
deceivers	dɪ.'si.vʌz
good-doing	'ɡʊəd.'dʉː.ɪŋ
deceitfulness	dɪ.'sit.fʌl.nʌs
lips.<|endoftext|><|endoftext|><|endoftext|><|endoftext|><|endoftext|><|endoftext|><|endoftext|><|endoftext|><|endoftext|><|endoftext	'lɪp.'sɛn.dəʊf.`tɛk.'stɛn.dəʊf.`tɛk.'stɛn.dəʊf.`tɛk.'stɛn.dəʊf.`tɛk.'stɛn.dəʊf.`tɛk.'stɛn.dəʊf.`tɛk.'stɛn.dəʊf.`tɛk.'stɛn.dəʊf.`tɛk.'stɛn.dəʊf.`tɛk.'stɛn.dəʊf.`tɛkst
well."<|endoftext|><|endoftext|><|endoftext|><|endoftext|><|endoftext|><|endoftext|><|endoftext|><|endoftext	'wɛl.'dɑt.bʌk.`slæ.'ʃɛn.dəʊf.`tɛk.'stɛn.dəʊf.`tɛk.'stɛn.dəʊf.`tɛk.'stɛn.dəʊf.`tɛk.'stɛn.dəʊf.`tɛk.'stɛn.dəʊf.`tɛk.'stɛn.dəʊf.`tɛk.'stɛn.dəʊf.`tɛkst
thyself.<|endoftext|><|endoftext|><|endoftext|><|endoftext|><|endoftext|><|endoftext|><|endoftext|><|endoftext	θaɪ.'sɛl.'fɛn.dəʊf.`tɛk.'stɛn.dəʊf.`tɛk.'stɛn.dəʊf.`tɛk.'stɛn.dəʊf.`tɛk.'stɛn.dəʊf.`tɛk.'stɛn.dəʊf.`tɛk.'stɛn.dəʊf.`tɛk.'stɛn.dəʊf.`tɛkst
wrong-doing	'ɹɑŋ.'dʉː.ɪŋ
life.thy	'laɪf.'dɑt.`ðaɪ
thessalonians	`θɛ.sʌ.'ləʊ.neɪ.ʌnz
righteousness.and	'ɹaɪ.tʃʌ.snʌs.'dɑ.tænd
thine.but	`ðaɪn.'dɑt.`bʌt
wife.for	'waɪf.'dɑt.fɔː
19:12	'naɪn.tin.'twɛlv
thee.but	`ði.'dɑt.`bʌt
whensoever	wɛn.`səʊ.'ɛ.vʌ
die.<|endoftext|><|endoftext|><|endoftext|><|endoftext|><|endoftext|><|endoftext|><|endoftext	'daɪ.'ɛn.dəʊf.`tɛk.'stɛn.dəʊf.`tɛk.'stɛn.dəʊf.`tɛk.'stɛn.dəʊf.`tɛk.'stɛn.dəʊf.`tɛk.'stɛn.dəʊf.`tɛk.'stɛn.dəʊf.`tɛkst
he,'may	hi.'bæk.slæʃ.'meɪ
transgressions.<|endoftext|><|endoftext|><|endoftext|><|endoftext|><|endoftext|><|endoftext|><|endoftext|><|endoftext|><|endoftext|><|endoftext|><|endoftext|><|endoftext|><|endoftext|><|endoftext	tɹæns.'ɡɹɛ.ʃʌn.'zɛn.dəʊf.`tɛk.'stɛn.dəʊf.`tɛk.'stɛn.dəʊf.`tɛk.'stɛn.dəʊf.`tɛk.'stɛn.dəʊf.`tɛk.'stɛn.dəʊf.`tɛk.'stɛn.dəʊf.`tɛk.'stɛn.dəʊf.`tɛk.'stɛn.dəʊf.`tɛk.'stɛn.dəʊf.`tɛk.'stɛn.dəʊf.`tɛk.'stɛn.dəʊf.`tɛk.'stɛn.dəʊf.`tɛk.'stɛn.dəʊf.`tɛkst
sins.thy	'sɪnz.'dɑt.`ðaɪ
2and	'tʉː.ænd
penitency	'pɛ.nɪ.tʌn.sɪ
thenceforward	`θɛn.sɪ.'fɔː.wʌd
mine.<|endoftext|><|endoftext|><|endoftext|><|endoftext|><|endoftext|><|endoftext|><|endoftext|><|endoftext|><|endoftext|><|endoftext|><|endoftext|><|endoftext|><|endoftext|><|endoftext|><|endoftext|><|endoftext	'maɪ.'nɛn.dəʊf.`tɛk.'stɛn.dəʊf.`tɛk.'stɛn.dəʊf.`tɛk.'stɛn.dəʊf.`tɛk.'stɛn.dəʊf.`tɛk.'stɛn.dəʊf.`tɛk.'stɛn.dəʊf.`tɛk.'stɛn.dəʊf.`tɛk.'stɛn.dəʊf.`tɛk.'stɛn.dəʊf.`tɛk.'stɛn.dəʊf.`tɛk.'stɛn.dəʊf.`tɛk.'stɛn.dəʊf.`tɛk.'stɛn.dəʊf.`tɛk.'stɛn.dəʊf.`tɛk.'stɛn.dəʊf.`tɛkst
his.<|endoftext|><|endoftext|><|endoftext|><|endoftext|><|endoftext|><|endoftext|><|endoftext|><|endoftext|><|endoftext|><|endoftext|><|endoftext|><|endoftext|><|endoftext	'hɪ.'zɛn.dəʊf.`tɛk.'stɛn.dəʊf.`tɛk.'stɛn.dəʊf.`tɛk.'stɛn.dəʊf.`tɛk.'stɛn.dəʊf.`tɛk.'stɛn.dəʊf.`tɛk.'stɛn.dəʊf.`tɛk.'stɛn.dəʊf.`tɛk.'stɛn.dəʊf.`tɛk.'stɛn.dəʊf.`tɛk.'stɛn.dəʊf.`tɛk.'stɛn.dəʊf.`tɛk.'stɛn.dəʊf.`tɛkst
sins.for	'sɪnz.'dɑt.fɔː
sineth	'saɪ.nʌθ
molatryan	mʌ.'læ.tɹɪ.ʌn
guilt.<|endoftext|><|endoftext|><|endoftext|><|endoftext|><|endoftext|><|endoftext|><|endoftext|><|endoftext|><|endoftext|><|endoftext|><|endoftext|><|endoftext|><|endoftext|><|endoftext|><|endoftext	'ɡɪl.'tɛn.dəʊf.`tɛk.'stɛn.dəʊf.`tɛk.'stɛn.dəʊf.`tɛk.'stɛn.dəʊf.`tɛk.'stɛn.dəʊf.`tɛk.'stɛn.dəʊf.`tɛk.'stɛn.dəʊf.`tɛk.'stɛn.dəʊf.`tɛk.'stɛn.dəʊf.`tɛk.'stɛn.dəʊf.`tɛk.'stɛn.dəʊf.`tɛk.'stɛn.dəʊf.`tɛk.'stɛn.dəʊf.`tɛk.'stɛn.dəʊf.`tɛk.'stɛn.dəʊf.`tɛkst
own.for	'əʊn.'dɑt.fɔː
heart.thou	'hɑt.'dɑt.'ðaʊ
manifest.thou	'mæ.nɪ.`fɛst.'dɑt.'ðaʊ
yours.<|endoftext|><|endoftext|><|endoftext|><|endoftext|><|endoftext|><|endoftext|><|endoftext|><|endoftext|><|endoftext|><|endoftext|><|endoftext|><|endoftext|><|endoftext|><|endoftext	'jɔː.'zɛn.dəʊf.`tɛk.'stɛn.dəʊf.`tɛk.'stɛn.dəʊf.`tɛk.'stɛn.dəʊf.`tɛk.'stɛn.dəʊf.`tɛk.'stɛn.dəʊf.`tɛk.'stɛn.dəʊf.`tɛk.'stɛn.dəʊf.`tɛk.'stɛn.dəʊf.`tɛk.'stɛn.dəʊf.`tɛk.'stɛn.dəʊf.`tɛk.'stɛn.dəʊf.`tɛk.'stɛn.dəʊf.`tɛk.'stɛn.dəʊf.`tɛkst
mine.<|endoftext|><|endoftext|><|endoftext|><|endoftext|><|endoftext|><|endoftext|><|endoftext|><|endoftext|><|endoftext|><|endoftext|><|endoftext|><|endoftext|><|endoftext|><|endoftext|><|endoftext	'maɪ.'nɛn.dəʊf.`tɛk.'stɛn.dəʊf.`tɛk.'stɛn.dəʊf.`tɛk.'stɛn.dəʊf.`tɛk.'stɛn.dəʊf.`tɛk.'stɛn.dəʊf.`tɛk.'stɛn.dəʊf.`tɛk.'stɛn.dəʊf.`tɛk.'stɛn.dəʊf.`tɛk.'stɛn.dəʊf.`tɛk.'stɛn.dəʊf.`tɛk.'stɛn.dəʊf.`tɛk.'stɛn.dəʊf.`tɛk.'stɛn.dəʊf.`tɛk.'stɛn.dəʊf.`tɛkst
eath	'iθ
1the	'wɑn.ðʌ
2:16]and	'tʉː.'sɪk.sti.nænd
maggius	'mæ.ɡɪ.ʌs
sallallahu	`sæ.lʌ.'læ.hʉː
hearkening	'hɑ.kʌ.nɪŋ
nu'amu	'nʉː.'bæk.slæ.'ʃɑ.mʉː
il-iqbaq	'ɪ.'lɪk.bæk
fiddlehead	'fɪ.dʌl.`hɛd
lkv	`ɛl.`keɪ.'vi
foolishest	'fʉː.lɪ.ʃʌst
them.<|endoftext|><|endoftext|><|endoftext|><|endoftext|><|endoftext|><|endoftext|><|endoftext|><|endoftext	'ðɛ.'mɛn.dəʊf.`tɛk.'stɛn.dəʊf.`tɛk.'stɛn.dəʊf.`tɛk.'stɛn.dəʊf.`tɛk.'stɛn.dəʊf.`tɛk.'stɛn.dəʊf.`tɛk.'stɛn.dəʊf.`tɛk.'stɛn.dəʊf.`tɛkst
with.thou	wɪð.'dɑt.'ðaʊ
revenged	ɹɪ.'vɛndʒd
tertullianus	'təː.tʌ.`leɪ.ʌ.nʌs
12)--the	'twɛlv.ðʌ
weak.<|endoftext|><|endoftext|><|endoftext|><|endoftext|><|endoftext|><|endoftext|><|endoftext|><|endoftext|><|endoftext|><|endoftext|><|endoftext|><|endoftext	'wi.'kɛn.dəʊf.`tɛk.'stɛn.dəʊf.`tɛk.'stɛn.dəʊf.`tɛk.'stɛn.dəʊf.`tɛk.'stɛn.dəʊf.`tɛk.'stɛn.dəʊf.`tɛk.'stɛn.dəʊf.`tɛk.'stɛn.dəʊf.`tɛk.'stɛn.dəʊf.`tɛk.'stɛn.dəʊf.`tɛk.'stɛn.dəʊf.`tɛk.'stɛn.dəʊf.`tɛkst
wicked.<|endoftext|><|endoftext|><|endoftext|><|endoftext|><|endoftext|><|endoftext|><|endoftext|><|endoftext|><|endoftext|><|endoftext|><|endoftext	'wɪ.kɪ.'dɛn.dəʊf.`tɛk.'stɛn.dəʊf.`tɛk.'stɛn.dəʊf.`tɛk.'stɛn.dəʊf.`tɛk.'stɛn.dəʊf.`tɛk.'stɛn.dəʊf.`tɛk.'stɛn.dəʊf.`tɛk.'stɛn.dəʊf.`tɛk.'stɛn.dəʊf.`tɛk.'stɛn.dəʊf.`tɛk.'stɛn.dəʊf.`tɛkst
nepotisms	'nɛ.pʌ.`tɪ.zʌmz
xxii	`ɹəʊ.mʌn.'twɛn.tɪ.'tʉː
nrs	`ɛ.`nɑ.'ɹɛs
437ff	'fɔː.'hʌn.dɹʌ.dʌn.'θəː.tɪ.'sɛ.vʌ.`nɛ.'fɛf
bethsaida	bɛθ.'seɪ.dʌ
a.m.h.k	`eɪ.`ɛ.`meɪtʃ.'keɪ
precept.thy	'pɹi.sɛpt.'dɑt.`ðaɪ
endure.and	ɛnd.'jʊə.'dɑ.tænd
tathagata	`tæ.θʌ.'ɡɑ.tʌ
stronger.<|endoftext|><|endoftext|><|endoftext|><|endoftext|><|endoftext|><|endoftext	'stɹɑŋ.ɡʌ.'ɛn.dəʊf.`tɛk.'stɛn.dəʊf.`tɛk.'stɛn.dəʊf.`tɛk.'stɛn.dəʊf.`tɛk.'stɛn.dəʊf.`tɛk.'stɛn.dəʊf.`tɛkst
27]thou	'twɛn.tɪ.'sɛ.vʌn.'ðaʊ
drunk.<|endoftext|><|endoftext|><|endoftext|><|endoftext|><|endoftext|><|endoftext	'dɹʌŋ.'kɛn.dəʊf.`tɛk.'stɛn.dəʊf.`tɛk.'stɛn.dəʊf.`tɛk.'stɛn.dəʊf.`tɛk.'stɛn.dəʊf.`tɛk.'stɛn.dəʊf.`tɛkst
endoftext|><|endoftext|><|endoftext|><|endoftext|><|endoftext|><|endoftext|><|endoftext|><|endoftext|><|endoftext|><|endoftext|><|endoftext	'ɛn.dəʊf.`tɛk.'stɛn.dəʊf.`tɛk.'stɛn.dəʊf.`tɛk.'stɛn.dəʊf.`tɛk.'stɛn.dəʊf.`tɛk.'stɛn.dəʊf.`tɛk.'stɛn.dəʊf.`tɛk.'stɛn.dəʊf.`tɛk.'stɛn.dəʊf.`tɛk.'stɛn.dəʊf.`tɛk.'stɛn.dəʊf.`tɛkst
10)--and	'tɛ.nænd
mighty.thou	'maɪ.tɪ.'dɑt.'ðaʊ
israel.and	'ɪs.ɹeɪl.'dɑ.tænd
weak.<|endoftext|><|endoftext|><|endoftext|><|endoftext|><|endoftext|><|endoftext|><|endoftext|><|endoftext|><|endoftext	'wi.'kɛn.dəʊf.`tɛk.'stɛn.dəʊf.`tɛk.'stɛn.dəʊf.`tɛk.'stɛn.dəʊf.`tɛk.'stɛn.dəʊf.`tɛk.'stɛn.dəʊf.`tɛk.'stɛn.dəʊf.`tɛk.'stɛn.dəʊf.`tɛk.'stɛn.dəʊf.`tɛkst
sawest	'sɔːst
up.<|endoftext|><|endoftext|><|endoftext|><|endoftext|><|endoftext|><|endoftext|><|endoftext|><|endoftext	'ʌ.'pɛn.dəʊf.`tɛk.'stɛn.dəʊf.`tɛk.'stɛn.dəʊf.`tɛk.'stɛn.dəʊf.`tɛk.'stɛn.dəʊf.`tɛk.'stɛn.dəʊf.`tɛk.'stɛn.dəʊf.`tɛk.'stɛn.dəʊf.`tɛkst
tishriva	'tɪ.ʃɹɪ.vʌ
believe.<|endoftext|><|endoftext|><|endoftext|><|endoftext|><|endoftext|><|endoftext	bɪ.'li.'vɛn.dəʊf.`tɛk.'stɛn.dəʊf.`tɛk.'stɛn.dəʊf.`tɛk.'stɛn.dəʊf.`tɛk.'stɛn.dəʊf.`tɛk.'stɛn.dəʊf.`tɛkst
old.<|endoftext|><|endoftext|><|endoftext|><|endoftext|><|endoftext|><|endoftext|><|endoftext|><|endoftext|><|endoftext|><|endoftext	'əʊl.'dɛn.dəʊf.`tɛk.'stɛn.dəʊf.`tɛk.'stɛn.dəʊf.`tɛk.'stɛn.dəʊf.`tɛk.'stɛn.dəʊf.`tɛk.'stɛn.dəʊf.`tɛk.'stɛn.dəʊf.`tɛk.'stɛn.dəʊf.`tɛk.'stɛn.dəʊf.`tɛk.'stɛn.dəʊf.`tɛkst
nothing.and	'nʌ.θɪŋ.'dɑ.tænd
hitherst	'hɪ.ðʌst
firm.<|endoftext|><|endoftext|><|endoftext|><|endoftext|><|endoftext|><|endoftext|><|endoftext|><|endoftext|><|endoftext|><|endoftext	'fəː.'mɛn.dəʊf.`tɛk.'stɛn.dəʊf.`tɛk.'stɛn.dəʊf.`tɛk.'stɛn.dəʊf.`tɛk.'stɛn.dəʊf.`tɛk.'stɛn.dəʊf.`tɛk.'stɛn.dəʊf.`tɛk.'stɛn.dəʊf.`tɛk.'stɛn.dəʊf.`tɛk.'stɛn.dəʊf.`tɛkst
them,for	'ðɛm.fɔː
us.<|endoftext|><|endoftext|><|endoftext|><|endoftext|><|endoftext|><|endoftext|><|endoftext|><|endoftext|><|endoftext|><|endoftext	'ʌ.'sɛn.dəʊf.`tɛk.'stɛn.dəʊf.`tɛk.'stɛn.dəʊf.`tɛk.'stɛn.dəʊf.`tɛk.'stɛn.dəʊf.`tɛk.'stɛn.dəʊf.`tɛk.'stɛn.dəʊf.`tɛk.'stɛn.dəʊf.`tɛk.'stɛn.dəʊf.`tɛk.'stɛn.dəʊf.`tɛkst
thoughtest	'θɔː.tʌst
thee—for	'ði.fɔː
wistst	'wɪstst
5]and	'faɪ.vænd
well-pleased	'wɛl.'plizd
tirmidh	'təː.mɪ
lamentations	lʌ.mɪn.'teɪ.ʃʌnz
seekst	'sikst
therewith	ðəː.'wɪð
destroy?<|endoftext|><|endoftext|><|endoftext|><|endoftext|><|endoftext|><|endoftext|><|endoftext|><|endoftext	dɪ.'stɹɔɪ.'ɛn.dəʊf.`tɛk.'stɛn.dəʊf.`tɛk.'stɛn.dəʊf.`tɛk.'stɛn.dəʊf.`tɛk.'stɛn.dəʊf.`tɛk.'stɛn.dəʊf.`tɛk.'stɛn.dəʊf.`tɛk.'stɛn.dəʊf.`tɛkst
god-giver	'ɡɑd.'ɡɪ.vʌ
name,thou	'neɪm.'ðaʊ
seekth	'sikθ
do.<|endoftext|><|endoftext|><|endoftext|><|endoftext|><|endoftext|><|endoftext|><|endoftext|><|endoftext|><|endoftext|><|endoftext|><|endoftext|><|endoftext|><|endoftext|><|endoftext	'dʉː.'ɛn.dəʊf.`tɛk.'stɛn.dəʊf.`tɛk.'stɛn.dəʊf.`tɛk.'stɛn.dəʊf.`tɛk.'stɛn.dəʊf.`tɛk.'stɛn.dəʊf.`tɛk.'stɛn.dəʊf.`tɛk.'stɛn.dəʊf.`tɛk.'stɛn.dəʊf.`tɛk.'stɛn.dəʊf.`tɛk.'stɛn.dəʊf.`tɛk.'stɛn.dəʊf.`tɛk.'stɛn.dəʊf.`tɛk.'stɛn.dəʊf.`tɛkst
chrys	'kɹaɪz
twerken	'twəː.kʌn
mammon	'mæ.mʌn
believe.<|endoftext|><|endoftext|><|endoftext|><|endoftext|><|endoftext|><|endoftext|><|endoftext|><|endoftext|><|endoftext|><|endoftext|><|endoftext|><|endoftext|><|endoftext	bɪ.'li.'vɛn.dəʊf.`tɛk.'stɛn.dəʊf.`tɛk.'stɛn.dəʊf.`tɛk.'stɛn.dəʊf.`tɛk.'stɛn.dəʊf.`tɛk.'stɛn.dəʊf.`tɛk.'stɛn.dəʊf.`tɛk.'stɛn.dəʊf.`tɛk.'stɛn.dəʊf.`tɛk.'stɛn.dəʊf.`tɛk.'stɛn.dəʊf.`tɛk.'stɛn.dəʊf.`tɛk.'stɛn.dəʊf.`tɛkst
believe,<|endoftext|><|endoftext|><|endoftext|><|endoftext|><|endoftext|><|endoftext|><|endoftext|><|endoftext|><|endoftext	bɪ.'li.'vɛn.dəʊf.`tɛk.'stɛn.dəʊf.`tɛk.'stɛn.dəʊf.`tɛk.'stɛn.dəʊf.`tɛk.'stɛn.dəʊf.`tɛk.'stɛn.dəʊf.`tɛk.'stɛn.dəʊf.`tɛk.'stɛn.dəʊf.`tɛk.'stɛn.dəʊf.`tɛkst
thee.<|endoftext|><|endoftext|><|endoftext|><|endoftext|><|endoftext|><|endoftext|><|endoftext|><|endoftext|><|endoftext|><|endoftext|><|endoftext|><|endoftext|><|endoftext|><|endoftext|><|endoftext	'ði.'ɛn.dəʊf.`tɛk.'stɛn.dəʊf.`tɛk.'stɛn.dəʊf.`tɛk.'stɛn.dəʊf.`tɛk.'stɛn.dəʊf.`tɛk.'stɛn.dəʊf.`tɛk.'stɛn.dəʊf.`tɛk.'stɛn.dəʊf.`tɛk.'stɛn.dəʊf.`tɛk.'stɛn.dəʊf.`tɛk.'stɛn.dəʊf.`tɛk.'stɛn.dəʊf.`tɛk.'stɛn.dəʊf.`tɛk.'stɛn.dəʊf.`tɛk.'stɛn.dəʊf.`tɛkst
forn	'fɔːn
am.<|endoftext|><|endoftext|><|endoftext|><|endoftext|><|endoftext|><|endoftext|><|endoftext|><|endoftext|><|endoftext|><|endoftext|><|endoftext|><|endoftext|><|endoftext|><|endoftext	'æ.'mɛn.dəʊf.`tɛk.'stɛn.dəʊf.`tɛk.'stɛn.dəʊf.`tɛk.'stɛn.dəʊf.`tɛk.'stɛn.dəʊf.`tɛk.'stɛn.dəʊf.`tɛk.'stɛn.dəʊf.`tɛk.'stɛn.dəʊf.`tɛk.'stɛn.dəʊf.`tɛk.'stɛn.dəʊf.`tɛk.'stɛn.dəʊf.`tɛk.'stɛn.dəʊf.`tɛk.'stɛn.dəʊf.`tɛk.'stɛn.dəʊf.`tɛkst
them,thy	`ðɛm.'ðaɪ
men.<|endoftext|><|endoftext|><|endoftext|><|endoftext|><|endoftext|><|endoftext	'mɛ.'nɛn.dəʊf.`tɛk.'stɛn.dəʊf.`tɛk.'stɛn.dəʊf.`tɛk.'stɛn.dəʊf.`tɛk.'stɛn.dəʊf.`tɛk.'stɛn.dəʊf.`tɛkst
see.<|endoftext|><|endoftext|><|endoftext|><|endoftext|><|endoftext|><|endoftext|><|endoftext|><|endoftext|><|endoftext|><|endoftext|><|endoftext	'si.'ɛn.dəʊf.`tɛk.'stɛn.dəʊf.`tɛk.'stɛn.dəʊf.`tɛk.'stɛn.dəʊf.`tɛk.'stɛn.dəʊf.`tɛk.'stɛn.dəʊf.`tɛk.'stɛn.dəʊf.`tɛk.'stɛn.dəʊf.`tɛk.'stɛn.dəʊf.`tɛk.'stɛn.dəʊf.`tɛk.'stɛn.dəʊf.`tɛkst
gone.<|endoftext|><|endoftext|><|endoftext|><|endoftext|><|endoftext|><|endoftext|><|endoftext|><|endoftext|><|endoftext|><|endoftext|><|endoftext|><|endoftext	'ɡɑ.'nɛn.dəʊf.`tɛk.'stɛn.dəʊf.`tɛk.'stɛn.dəʊf.`tɛk.'stɛn.dəʊf.`tɛk.'stɛn.dəʊf.`tɛk.'stɛn.dəʊf.`tɛk.'stɛn.dəʊf.`tɛk.'stɛn.dəʊf.`tɛk.'stɛn.dəʊf.`tɛk.'stɛn.dəʊf.`tɛk.'stɛn.dəʊf.`tɛk.'stɛn.dəʊf.`tɛkst
find,i	'faɪn.'daɪ
soughtest	'sɔː.tʌst
desireth	dɪ.'zaɪ.ʌ.ɹʌθ
myught	'maɪ.ʌt
mine.<|endoftext|><|endoftext|><|endoftext|><|endoftext|><|endoftext|><|endoftext|><|endoftext|><|endoftext|><|endoftext|><|endoftext|><|endoftext|><|endoftext|><|endoftext|><|endoftext	'maɪ.'nɛn.dəʊf.`tɛk.'stɛn.dəʊf.`tɛk.'stɛn.dəʊf.`tɛk.'stɛn.dəʊf.`tɛk.'stɛn.dəʊf.`tɛk.'stɛn.dəʊf.`tɛk.'stɛn.dəʊf.`tɛk.'stɛn.dəʊf.`tɛk.'stɛn.dəʊf.`tɛk.'stɛn.dəʊf.`tɛk.'stɛn.dəʊf.`tɛk.'stɛn.dəʊf.`tɛk.'stɛn.dəʊf.`tɛk.'stɛn.dəʊf.`tɛkst
prayth	'pɹeɪθ
theirselves	θəː.'sɛlvz
them,<|endoftext|><|endoftext|><|endoftext|><|endoftext|><|endoftext|><|endoftext|><|endoftext|><|endoftext|><|endoftext|><|endoftext|><|endoftext|><|endoftext|><|endoftext	'ðɛ.'mɛn.dəʊf.`tɛk.'stɛn.dəʊf.`tɛk.'stɛn.dəʊf.`tɛk.'stɛn.dəʊf.`tɛk.'stɛn.dəʊf.`tɛk.'stɛn.dəʊf.`tɛk.'stɛn.dəʊf.`tɛk.'stɛn.dəʊf.`tɛk.'stɛn.dəʊf.`tɛk.'stɛn.dəʊf.`tɛk.'stɛn.dəʊf.`tɛk.'stɛn.dəʊf.`tɛk.'stɛn.dəʊf.`tɛkst
them.<|endoftext|><|endoftext|><|endoftext|><|endoftext|><|endoftext|><|endoftext|><|endoftext|><|endoftext|><|endoftext|><|endoftext|><|endoftext|><|endoftext|><|endoftext|><|endoftext|><|endoftext	'ðɛ.'mɛn.dəʊf.`tɛk.'stɛn.dəʊf.`tɛk.'stɛn.dəʊf.`tɛk.'stɛn.dəʊf.`tɛk.'stɛn.dəʊf.`tɛk.'stɛn.dəʊf.`tɛk.'stɛn.dəʊf.`tɛk.'stɛn.dəʊf.`tɛk.'stɛn.dəʊf.`tɛk.'stɛn.dəʊf.`tɛk.'stɛn.dəʊf.`tɛk.'stɛn.dəʊf.`tɛk.'stɛn.dəʊf.`tɛk.'stɛn.dəʊf.`tɛk.'stɛn.dəʊf.`tɛkst
therefor	ðəː.'fɔː
thinkest	'θɪŋ.kʌst
believe.<|endoftext|><|endoftext|><|endoftext|><|endoftext|><|endoftext|><|endoftext|><|endoftext|><|endoftext|><|endoftext|><|endoftext|><|endoftext|><|endoftext|><|endoftext|><|endoftext|><|endoftext|><|endoftext|><|endoftext	bɪ.'li.'vɛn.dəʊf.`tɛk.'stɛn.dəʊf.`tɛk.'stɛn.dəʊf.`tɛk.'stɛn.dəʊf.`tɛk.'stɛn.dəʊf.`tɛk.'stɛn.dəʊf.`tɛk.'stɛn.dəʊf.`tɛk.'stɛn.dəʊf.`tɛk.'stɛn.dəʊf.`tɛk.'stɛn.dəʊf.`tɛk.'stɛn.dəʊf.`tɛk.'stɛn.dəʊf.`tɛk.'stɛn.dəʊf.`tɛk.'stɛn.dəʊf.`tɛk.'stɛn.dəʊf.`tɛk.'stɛn.dəʊf.`tɛk.'stɛn.dəʊf.`tɛkst
flesh.<|endoftext|><|endoftext|><|endoftext|><|endoftext|><|endoftext|><|endoftext|><|endoftext|><|endoftext|><|endoftext	'flɛ.'ʃɛn.dəʊf.`tɛk.'stɛn.dəʊf.`tɛk.'stɛn.dəʊf.`tɛk.'stɛn.dəʊf.`tɛk.'stɛn.dəʊf.`tɛk.'stɛn.dəʊf.`tɛk.'stɛn.dəʊf.`tɛk.'stɛn.dəʊf.`tɛk.'stɛn.dəʊf.`tɛkst
them.<|endoftext|><|endoftext|><|endoftext|><|endoftext|><|endoftext|><|endoftext|><|endoftext|><|endoftext|><|endoftext|><|endoftext|><|endoftext|><|endoftext|><|endoftext|><|endoftext|><|endoftext|><|endoftext	'ðɛ.'mɛn.dəʊf.`tɛk.'stɛn.dəʊf.`tɛk.'stɛn.dəʊf.`tɛk.'stɛn.dəʊf.`tɛk.'stɛn.dəʊf.`tɛk.'stɛn.dəʊf.`tɛk.'stɛn.dəʊf.`tɛk.'stɛn.dəʊf.`tɛk.'stɛn.dəʊf.`tɛk.'stɛn.dəʊf.`tɛk.'stɛn.dəʊf.`tɛk.'stɛn.dəʊf.`tɛk.'stɛn.dəʊf.`tɛk.'stɛn.dəʊf.`tɛk.'stɛn.dəʊf.`tɛk.'stɛn.dəʊf.`tɛkst
i.<|endoftext|><|endoftext|><|endoftext|><|endoftext|><|endoftext|><|endoftext|><|endoftext|><|endoftext|><|endoftext|><|endoftext|><|endoftext|><|endoftext|><|endoftext|><|endoftext|><|endoftext|><|endoftext	'aɪ.'ɛn.dəʊf.`tɛk.'stɛn.dəʊf.`tɛk.'stɛn.dəʊf.`tɛk.'stɛn.dəʊf.`tɛk.'stɛn.dəʊf.`tɛk.'stɛn.dəʊf.`tɛk.'stɛn.dəʊf.`tɛk.'stɛn.dəʊf.`tɛk.'stɛn.dəʊf.`tɛk.'stɛn.dəʊf.`tɛk.'stɛn.dəʊf.`tɛk.'stɛn.dəʊf.`tɛk.'stɛn.dəʊf.`tɛk.'stɛn.dəʊf.`tɛk.'stɛn.dəʊf.`tɛk.'stɛn.dəʊf.`tɛkst
a)st	ʌ.'sʌnt
judges.<|endoftext|><|endoftext|><|endoftext|><|endoftext|><|endoftext|><|endoftext|><|endoftext|><|endoftext|><|endoftext|><|endoftext|><|endoftext	'dʒʌ.dʒɪ.'zɛn.dəʊf.`tɛk.'stɛn.dəʊf.`tɛk.'stɛn.dəʊf.`tɛk.'stɛn.dəʊf.`tɛk.'stɛn.dəʊf.`tɛk.'stɛn.dəʊf.`tɛk.'stɛn.dəʊf.`tɛk.'stɛn.dəʊf.`tɛk.'stɛn.dəʊf.`tɛk.'stɛn.dəʊf.`tɛk.'stɛn.dəʊf.`tɛkst
standest	'stæn.dʌst
themest	'θi.mʌst
be.thy	bi.'dɑt.`ðaɪ
not.<|endoftext|><|endoftext|><|endoftext|><|endoftext|><|endoftext|><|endoftext|><|endoftext|><|endoftext|><|endoftext|><|endoftext|><|endoftext|><|endoftext|><|endoftext|><|endoftext|><|endoftext|><|endoftext	'nɑ.'tɛn.dəʊf.`tɛk.'stɛn.dəʊf.`tɛk.'stɛn.dəʊf.`tɛk.'stɛn.dəʊf.`tɛk.'stɛn.dəʊf.`tɛk.'stɛn.dəʊf.`tɛk.'stɛn.dəʊf.`tɛk.'stɛn.dəʊf.`tɛk.'stɛn.dəʊf.`tɛk.'stɛn.dəʊf.`tɛk.'stɛn.dəʊf.`tɛk.'stɛn.dəʊf.`tɛk.'stɛn.dəʊf.`tɛk.'stɛn.dəʊf.`tɛk.'stɛn.dəʊf.`tɛk.'stɛn.dəʊf.`tɛkst
that.<|endoftext|><|endoftext|><|endoftext|><|endoftext|><|endoftext|><|endoftext|><|endoftext|><|endoftext|><|endoftext|><|endoftext|><|endoftext|><|endoftext|><|endoftext|><|endoftext	'ðæ.'tɛn.dəʊf.`tɛk.'stɛn.dəʊf.`tɛk.'stɛn.dəʊf.`tɛk.'stɛn.dəʊf.`tɛk.'stɛn.dəʊf.`tɛk.'stɛn.dəʊf.`tɛk.'stɛn.dəʊf.`tɛk.'stɛn.dəʊf.`tɛk.'stɛn.dəʊf.`tɛk.'stɛn.dəʊf.`tɛk.'stɛn.dəʊf.`tɛk.'stɛn.dəʊf.`tɛk.'stɛn.dəʊf.`tɛk.'stɛn.dəʊf.`tɛkst
sit.<|endoftext|><|endoftext|><|endoftext|><|endoftext|><|endoftext|><|endoftext|><|endoftext|><|endoftext|><|endoftext|><|endoftext|><|endoftext|><|endoftext|><|endoftext	'sɪ.'tɛn.dəʊf.`tɛk.'stɛn.dəʊf.`tɛk.'stɛn.dəʊf.`tɛk.'stɛn.dəʊf.`tɛk.'stɛn.dəʊf.`tɛk.'stɛn.dəʊf.`tɛk.'stɛn.dəʊf.`tɛk.'stɛn.dəʊf.`tɛk.'stɛn.dəʊf.`tɛk.'stɛn.dəʊf.`tɛk.'stɛn.dəʊf.`tɛk.'stɛn.dəʊf.`tɛk.'stɛn.dəʊf.`tɛkst
lord.<|endoftext|><|endoftext|><|endoftext|><|endoftext|><|endoftext|><|endoftext|><|endoftext|><|endoftext|><|endoftext|><|endoftext|><|endoftext|><|endoftext|><|endoftext	'lɔː.'dɛn.dəʊf.`tɛk.'stɛn.dəʊf.`tɛk.'stɛn.dəʊf.`tɛk.'stɛn.dəʊf.`tɛk.'stɛn.dəʊf.`tɛk.'stɛn.dəʊf.`tɛk.'stɛn.dəʊf.`tɛk.'stɛn.dəʊf.`tɛk.'stɛn.dəʊf.`tɛk.'stɛn.dəʊf.`tɛk.'stɛn.dəʊf.`tɛk.'stɛn.dəʊf.`tɛk.'stɛn.dəʊf.`tɛkst
thee.thy	`ði.'dɑt.`ðaɪ
judgment,for	'dʒʌdʒ.mʌnt.fɔː
disciples.<|endoftext|><|endoftext|><|endoftext|><|endoftext|><|endoftext|><|endoftext|><|endoftext|><|endoftext|><|endoftext|><|endoftext|><|endoftext|><|endoftext|><|endoftext	dɪ.'saɪ.pʌl.'zɛn.dəʊf.`tɛk.'stɛn.dəʊf.`tɛk.'stɛn.dəʊf.`tɛk.'stɛn.dəʊf.`tɛk.'stɛn.dəʊf.`tɛk.'stɛn.dəʊf.`tɛk.'stɛn.dəʊf.`tɛk.'stɛn.dəʊf.`tɛk.'stɛn.dəʊf.`tɛk.'stɛn.dəʊf.`tɛk.'stɛn.dəʊf.`tɛk.'stɛn.dəʊf.`tɛk.'stɛn.dəʊf.`tɛkst
wonderest	'wʌn.dʌ.ɹʌst
be.<|endoftext|><|endoftext|><|endoftext|><|endoftext|><|endoftext|><|endoftext|><|endoftext|><|endoftext|><|endoftext|><|endoftext|><|endoftext|><|endoftext|><|endoftext|><|endoftext|><|endoftext|><|endoftext	'bi.'ɛn.dəʊf.`tɛk.'stɛn.dəʊf.`tɛk.'stɛn.dəʊf.`tɛk.'stɛn.dəʊf.`tɛk.'stɛn.dəʊf.`tɛk.'stɛn.dəʊf.`tɛk.'stɛn.dəʊf.`tɛk.'stɛn.dəʊf.`tɛk.'stɛn.dəʊf.`tɛk.'stɛn.dəʊf.`tɛk.'stɛn.dəʊf.`tɛk.'stɛn.dəʊf.`tɛk.'stɛn.dəʊf.`tɛk.'stɛn.dəʊf.`tɛk.'stɛn.dəʊf.`tɛk.'stɛn.dəʊf.`tɛkst
l.c	`ɛl.'si
ownself.<|endoftext|><|endoftext|><|endoftext|><|endoftext|><|endoftext|><|endoftext|><|endoftext	əʊn.'sɛl.'fɛn.dəʊf.`tɛk.'stɛn.dəʊf.`tɛk.'stɛn.dəʊf.`tɛk.'stɛn.dəʊf.`tɛk.'stɛn.dəʊf.`tɛk.'stɛn.dəʊf.`tɛk.'stɛn.dəʊf.`tɛkst
judge.<|endoftext|><|endoftext|><|endoftext|><|endoftext|><|endoftext|><|endoftext|><|endoftext|><|endoftext|><|endoftext|><|endoftext|><|endoftext	'dʒʌ.'dʒɛn.dəʊf.`tɛk.'stɛn.dəʊf.`tɛk.'stɛn.dəʊf.`tɛk.'stɛn.dəʊf.`tɛk.'stɛn.dəʊf.`tɛk.'stɛn.dəʊf.`tɛk.'stɛn.dəʊf.`tɛk.'stɛn.dəʊf.`tɛk.'stɛn.dəʊf.`tɛk.'stɛn.dəʊf.`tɛk.'stɛn.dəʊf.`tɛkst
seek.<|endoftext|><|endoftext|><|endoftext|><|endoftext|><|endoftext|><|endoftext|><|endoftext|><|endoftext|><|endoftext|><|endoftext|><|endoftext|><|endoftext|><|endoftext|><|endoftext	'si.'kɛn.dəʊf.`tɛk.'stɛn.dəʊf.`tɛk.'stɛn.dəʊf.`tɛk.'stɛn.dəʊf.`tɛk.'stɛn.dəʊf.`tɛk.'stɛn.dəʊf.`tɛk.'stɛn.dəʊf.`tɛk.'stɛn.dəʊf.`tɛk.'stɛn.dəʊf.`tɛk.'stɛn.dəʊf.`tɛk.'stɛn.dəʊf.`tɛk.'stɛn.dəʊf.`tɛk.'stɛn.dəʊf.`tɛk.'stɛn.dəʊf.`tɛkst
also.<|endoftext|><|endoftext|><|endoftext|><|endoftext|><|endoftext|><|endoftext|><|endoftext|><|endoftext|><|endoftext|><|endoftext|><|endoftext|><|endoftext|><|endoftext	'ɑl.səʊ.'ɛn.dəʊf.`tɛk.'stɛn.dəʊf.`tɛk.'stɛn.dəʊf.`tɛk.'stɛn.dəʊf.`tɛk.'stɛn.dəʊf.`tɛk.'stɛn.dəʊf.`tɛk.'stɛn.dəʊf.`tɛk.'stɛn.dəʊf.`tɛk.'stɛn.dəʊf.`tɛk.'stɛn.dəʊf.`tɛk.'stɛn.dəʊf.`tɛk.'stɛn.dəʊf.`tɛk.'stɛn.dəʊf.`tɛkst
him,and	'hɪ.mænd
deeds,and	'did.zænd
psa	`pi.`ɛ.'seɪ
house,thy	'haʊs.`ðaɪ
life,and	'laɪ.fænd
feareth	'feɪ.ʌ.ɹʌθ
knowsest	'nəʊzst
lighteth	'laɪ.tʌθ
thou.<|endoftext|><|endoftext|><|endoftext|><|endoftext|><|endoftext|><|endoftext|><|endoftext|><|endoftext|><|endoftext|><|endoftext|><|endoftext|><|endoftext	'ðaʊ.'ɛn.dəʊf.`tɛk.'stɛn.dəʊf.`tɛk.'stɛn.dəʊf.`tɛk.'stɛn.dəʊf.`tɛk.'stɛn.dəʊf.`tɛk.'stɛn.dəʊf.`tɛk.'stɛn.dəʊf.`tɛk.'stɛn.dəʊf.`tɛk.'stɛn.dəʊf.`tɛk.'stɛn.dəʊf.`tɛk.'stɛn.dəʊf.`tɛk.'stɛn.dəʊf.`tɛkst
judge,and	'dʒʌ.dʒænd
thinkst	'θɪŋkst
am.<|endoftext|><|endoftext|><|endoftext|><|endoftext|><|endoftext|><|endoftext|><|endoftext|><|endoftext|><|endoftext|><|endoftext|><|endoftext|><|endoftext|><|endoftext	'æ.'mɛn.dəʊf.`tɛk.'stɛn.dəʊf.`tɛk.'stɛn.dəʊf.`tɛk.'stɛn.dəʊf.`tɛk.'stɛn.dəʊf.`tɛk.'stɛn.dəʊf.`tɛk.'stɛn.dəʊf.`tɛk.'stɛn.dəʊf.`tɛk.'stɛn.dəʊf.`tɛk.'stɛn.dəʊf.`tɛk.'stɛn.dəʊf.`tɛk.'stɛn.dəʊf.`tɛk.'stɛn.dəʊf.`tɛkst
seek,and	'si.kænd
thou-like	'ðaʊ.'laɪk
judge.<|endoftext|><|endoftext|><|endoftext|><|endoftext|><|endoftext|><|endoftext|><|endoftext|><|endoftext|><|endoftext|><|endoftext|><|endoftext|><|endoftext|><|endoftext|><|endoftext|><|endoftext	'dʒʌ.'dʒɛn.dəʊf.`tɛk.'stɛn.dəʊf.`tɛk.'stɛn.dəʊf.`tɛk.'stɛn.dəʊf.`tɛk.'stɛn.dəʊf.`tɛk.'stɛn.dəʊf.`tɛk.'stɛn.dəʊf.`tɛk.'stɛn.dəʊf.`tɛk.'stɛn.dəʊf.`tɛk.'stɛn.dəʊf.`tɛk.'stɛn.dəʊf.`tɛk.'stɛn.dəʊf.`tɛk.'stɛn.dəʊf.`tɛk.'stɛn.dəʊf.`tɛk.'stɛn.dəʊf.`tɛkst
followeth	'fɑ.ləʊ.ʌθ
xii.<|endoftext|><|endoftext|><|endoftext|><|endoftext|><|endoftext|><|endoftext|><|endoftext|><|endoftext|><|endoftext|><|endoftext	`ɹəʊ.mʌn.'twɛl.'vɛn.dəʊf.`tɛk.'stɛn.dəʊf.`tɛk.'stɛn.dəʊf.`tɛk.'stɛn.dəʊf.`tɛk.'stɛn.dəʊf.`tɛk.'stɛn.dəʊf.`tɛk.'stɛn.dəʊf.`tɛk.'stɛn.dəʊf.`tɛk.'stɛn.dəʊf.`tɛk.'stɛn.dəʊf.`tɛkst
thee;<|endoftext|><|endoftext|><|endoftext|><|endoftext|><|endoftext|><|endoftext|><|endoftext|><|endoftext|><|endoftext|><|endoftext|><|endoftext|><|endoftext|><|endoftext	'ði.'ɛn.dəʊf.`tɛk.'stɛn.dəʊf.`tɛk.'stɛn.dəʊf.`tɛk.'stɛn.dəʊf.`tɛk.'stɛn.dəʊf.`tɛk.'stɛn.dəʊf.`tɛk.'stɛn.dəʊf.`tɛk.'stɛn.dəʊf.`tɛk.'stɛn.dəʊf.`tɛk.'stɛn.dəʊf.`tɛk.'stɛn.dəʊf.`tɛk.'stɛn.dəʊf.`tɛk.'stɛn.dəʊf.`tɛkst
them,and	'ðɛ.mænd
thereto,o	ðəː.'tʉː.'əʊ
thirstest	'θəː.stʌst
2nd1963	'sɛ.kʌnd.'naɪn.tin.'hʌn.dɹʌ.dʌn.'sɪk.stɪ.'θɹi
w)en	'dʌ.bʌl.`jʉː.'ɛn
34:22-29)<|endoftext|><|endoftext|><|endoftext|><|endoftext|><|endoftext|><|endoftext|><|endoftext|><|endoftext|><|endoftext|><|endoftext|><|endoftext	'θəː.tɪ.'fɔː.'twɛn.tɪ.'tʉː.'dæʃ.'twɛn.tɪ.'naɪ.'nɛn.dəʊf.`tɛk.'stɛn.dəʊf.`tɛk.'stɛn.dəʊf.`tɛk.'stɛn.dəʊf.`tɛk.'stɛn.dəʊf.`tɛk.'stɛn.dəʊf.`tɛk.'stɛn.dəʊf.`tɛk.'stɛn.dəʊf.`tɛk.'stɛn.dəʊf.`tɛk.'stɛn.dəʊf.`tɛk.'stɛn.dəʊf.`tɛkst
thimbe	'θɪmb
c.c	`si.'si
ch	`si.'eɪtʃ
amen.<|endoftext|><|endoftext|><|endoftext|><|endoftext|><|endoftext|><|endoftext|><|endoftext|><|endoftext|><|endoftext|><|endoftext|><|endoftext|><|endoftext|><|endoftext|><|endoftext|><|endoftext|><|endoftext|><|endoftext|><|endoftext	`ɑ.'mɛ.'nɛn.dəʊf.`tɛk.'stɛn.dəʊf.`tɛk.'stɛn.dəʊf.`tɛk.'stɛn.dəʊf.`tɛk.'stɛn.dəʊf.`tɛk.'stɛn.dəʊf.`tɛk.'stɛn.dəʊf.`tɛk.'stɛn.dəʊf.`tɛk.'stɛn.dəʊf.`tɛk.'stɛn.dəʊf.`tɛk.'stɛn.dəʊf.`tɛk.'stɛn.dəʊf.`tɛk.'stɛn.dəʊf.`tɛk.'stɛn.dəʊf.`tɛk.'stɛn.dəʊf.`tɛk.'stɛn.dəʊf.`tɛk.'stɛn.dəʊf.`tɛk.'stɛn.dəʊf.`tɛkst
thee.<|endoftext|><|endoftext|><|endoftext|><|endoftext|><|endoftext|><|endoftext|><|endoftext|><|endoftext|><|endoftext	'ði.'ɛn.dəʊf.`tɛk.'stɛn.dəʊf.`tɛk.'stɛn.dəʊf.`tɛk.'stɛn.dəʊf.`tɛk.'stɛn.dəʊf.`tɛk.'stɛn.dəʊf.`tɛk.'stɛn.dəʊf.`tɛk.'stɛn.dəʊf.`tɛk.'stɛn.dəʊf.`tɛkst
begone	bɪ.'ɡɑn
sv	`ɛs.'vi
3:19-20)<|endoftext|><|endoftext|><|endoftext|><|endoftext|><|endoftext|><|endoftext|><|endoftext|><|endoftext|><|endoftext|><|endoftext|><|endoftext	'θɹi.'naɪn.tin.'dæʃ.'twɛn.tɪ.'ɛn.dəʊf.`tɛk.'stɛn.dəʊf.`tɛk.'stɛn.dəʊf.`tɛk.'stɛn.dəʊf.`tɛk.'stɛn.dəʊf.`tɛk.'stɛn.dəʊf.`tɛk.'stɛn.dəʊf.`tɛk.'stɛn.dəʊf.`tɛk.'stɛn.dəʊf.`tɛk.'stɛn.dəʊf.`tɛk.'stɛn.dəʊf.`tɛkst
day-star	'deɪ.'stɑ
idol-worshiping	'aɪ.dʌl.'wəː.ʃɪ.pɪŋ
t.2:16-18	'ti.dɑt.'tʉː.'sɪk.stin.'dæ.'ʃeɪ.tin
threescore	'θɹi.skɔː
psal	'sæl
lord.<|endoftext|><|endoftext|><|endoftext|><|endoftext|><|endoftext|><|endoftext	'lɔː.'dɛn.dəʊf.`tɛk.'stɛn.dəʊf.`tɛk.'stɛn.dəʊf.`tɛk.'stɛn.dəʊf.`tɛk.'stɛn.dəʊf.`tɛk.'stɛn.dəʊf.`tɛkst
safe.<|endoftext|><|endoftext|><|endoftext|><|endoftext|><|endoftext|><|endoftext|><|endoftext|><|endoftext|><|endoftext|><|endoftext|><|endoftext	'seɪ.'fɛn.dəʊf.`tɛk.'stɛn.dəʊf.`tɛk.'stɛn.dəʊf.`tɛk.'stɛn.dəʊf.`tɛk.'stɛn.dəʊf.`tɛk.'stɛn.dəʊf.`tɛk.'stɛn.dəʊf.`tɛk.'stɛn.dəʊf.`tɛk.'stɛn.dəʊf.`tɛk.'stɛn.dəʊf.`tɛk.'stɛn.dəʊf.`tɛkst
ywes	'ɪwz
fool.<|endoftext|><|endoftext|><|endoftext|><|endoftext|><|endoftext|><|endoftext|><|endoftext	'fʉː.'lɛn.dəʊf.`tɛk.'stɛn.dəʊf.`tɛk.'stɛn.dəʊf.`tɛk.'stɛn.dəʊf.`tɛk.'stɛn.dəʊf.`tɛk.'stɛn.dəʊf.`tɛk.'stɛn.dəʊf.`tɛkst
terezin's	'tɛ.ɹɪ.`zɪn.'bæk.slæ.'ʃɛs
weaklings	'wi.klɪŋz
thyn	'θɪn
faithless	'feɪθ.lʌs
whisperings	'wɪ.spʌ.ɹɪŋz
transliteration	tɹæn.`slɪ.tʌ.'ɹeɪ.ʃʌn
9th:12	'naɪnθ.'kəʊ.lʌn.'twɛlv
5:12<|endoftext|><|endoftext|><|endoftext|><|endoftext|><|endoftext|><|endoftext|><|endoftext|><|endoftext|><|endoftext|><|endoftext|><|endoftext|><|endoftext|><|endoftext	'faɪv.'twɛl.'vɛn.dəʊf.`tɛk.'stɛn.dəʊf.`tɛk.'stɛn.dəʊf.`tɛk.'stɛn.dəʊf.`tɛk.'stɛn.dəʊf.`tɛk.'stɛn.dəʊf.`tɛk.'stɛn.dəʊf.`tɛk.'stɛn.dəʊf.`tɛk.'stɛn.dəʊf.`tɛk.'stɛn.dəʊf.`tɛk.'stɛn.dəʊf.`tɛk.'stɛn.dəʊf.`tɛk.'stɛn.dəʊf.`tɛkst
thye	'θaɪ
thrones	'θɹəʊnz
strong.<|endoftext|><|endoftext|><|endoftext|><|endoftext|><|endoftext|><|endoftext|><|endoftext|><|endoftext|><|endoftext|><|endoftext|><|endoftext|><|endoftext|><|endoftext	'stɹɑŋ.'ɛn.dəʊf.`tɛk.'stɛn.dəʊf.`tɛk.'stɛn.dəʊf.`tɛk.'stɛn.dəʊf.`tɛk.'stɛn.dəʊf.`tɛk.'stɛn.dəʊf.`tɛk.'stɛn.dəʊf.`tɛk.'stɛn.dəʊf.`tɛk.'stɛn.dəʊf.`tɛk.'stɛn.dəʊf.`tɛk.'stɛn.dəʊf.`tɛk.'stɛn.dəʊf.`tɛk.'stɛn.dəʊf.`tɛkst
amen.)<|endoftext|><|endoftext|><|endoftext|><|endoftext|><|endoftext|><|endoftext|><|endoftext|><|endoftext|><|endoftext|><|endoftext|><|endoftext|><|endoftext|><|endoftext|><|endoftext|><|endoftext|><|endoftext	`ɑ.'mɛ.'nɛn.dəʊf.`tɛk.'stɛn.dəʊf.`tɛk.'stɛn.dəʊf.`tɛk.'stɛn.dəʊf.`tɛk.'stɛn.dəʊf.`tɛk.'stɛn.dəʊf.`tɛk.'stɛn.dəʊf.`tɛk.'stɛn.dəʊf.`tɛk.'stɛn.dəʊf.`tɛk.'stɛn.dəʊf.`tɛk.'stɛn.dəʊf.`tɛk.'stɛn.dəʊf.`tɛk.'stɛn.dəʊf.`tɛk.'stɛn.dəʊf.`tɛk.'stɛn.dəʊf.`tɛk.'stɛn.dəʊf.`tɛkst
th-e	`ti.'eɪ.'tʃi
o'er-world	'əʊ.'bæk.slæ.'ʃəː.'wəːld
isha`i	'i.ʃʌ.'aɪ
ḥoonu`alāl	`lɛ.tʌ.'wɑ.'ni.'tʉː.'faɪ.'vəʊ.'əʊ.'ɛn.'jʉː.ʌ.'læl
עַשְעוֹת	'æ.jɪ.'næ.'ʃɪnʃ.'vɑ.'æ.jɪn.`væv.'tæv
abominations	ʌ.`bɑ.mɪ.'neɪ.ʃʌnz
believe.<|endoftext|><|endoftext|><|endoftext|><|endoftext|><|endoftext|><|endoftext|><|endoftext|><|endoftext|><|endoftext|><|endoftext|><|endoftext|><|endoftext|><|endoftext|><|endoftext	bɪ.'li.'vɛn.dəʊf.`tɛk.'stɛn.dəʊf.`tɛk.'stɛn.dəʊf.`tɛk.'stɛn.dəʊf.`tɛk.'stɛn.dəʊf.`tɛk.'stɛn.dəʊf.`tɛk.'stɛn.dəʊf.`tɛk.'stɛn.dəʊf.`tɛk.'stɛn.dəʊf.`tɛk.'stɛn.dəʊf.`tɛk.'stɛn.dəʊf.`tɛk.'stɛn.dəʊf.`tɛk.'stɛn.dəʊf.`tɛk.'stɛn.dəʊf.`tɛkst
thynself	θɪn.'sɛlf
5.—the	'faɪv.'ðʌ
r.s.y.d.t	`ɑ.`ɹɛ.'swaɪ.`di.'ti
t1:39,40	'ti.'wɑn.'kəʊ.lʌn.'θəː.tɪ.'naɪn.'fɔː.tɪ
paraam	'pæ.ɹʌ.`ɹæm
thievish	'θi.vɪʃ
a.s.w	`eɪ.`ɛs.'dʌ.bʌl.`jʉː
unbelief	ʌn.bɪ.'lif
false-believers	'fɑls.bɪ.'li.vʌz
of."<|endoftext|><|endoftext|><|endoftext|><|endoftext|><|endoftext|><|endoftext|><|endoftext|><|endoftext|><|endoftext	ɑv.'dɑt.bʌk.`slæ.'ʃɛn.dəʊf.`tɛk.'stɛn.dəʊf.`tɛk.'stɛn.dəʊf.`tɛk.'stɛn.dəʊf.`tɛk.'stɛn.dəʊf.`tɛk.'stɛn.dəʊf.`tɛk.'stɛn.dəʊf.`tɛk.'stɛn.dəʊf.`tɛk.'stɛn.dəʊf.`tɛkst
e.b	`i.'bi
s.c	`ɛs.'si
1.8)--it	'wɑn.pɔɪn.'teɪ.tɪt
xxxv	`ɹəʊ.mʌn.'θəː.tɪ.'faɪv
wherest	'wəːst
foundest	'faʊn.dʌst
perextend	'pɛ.ɹɪk.`stɛnd
far-fetched	'fɑ.'fɛtʃt
enlightens	ɛn.'laɪ.tʌnz
self-believer	'sɛlf.bɪ.'li.vʌ
dhamma	'dæ.mʌ
deceiver	dɪ.'si.vʌ
none.<|endoftext|><|endoftext|><|endoftext|><|endoftext|><|endoftext|><|endoftext|><|endoftext|><|endoftext|><|endoftext|><|endoftext	'nʌ.'nɛn.dəʊf.`tɛk.'stɛn.dəʊf.`tɛk.'stɛn.dəʊf.`tɛk.'stɛn.dəʊf.`tɛk.'stɛn.dəʊf.`tɛk.'stɛn.dəʊf.`tɛk.'stɛn.dəʊf.`tɛk.'stɛn.dəʊf.`tɛk.'stɛn.dəʊf.`tɛk.'stɛn.dəʊf.`tɛkst
mote'st	'məʊt.'bæk.slæʃ.sʌnt
end.<|endoftext|><|endoftext|><|endoftext|><|endoftext|><|endoftext|><|endoftext|><|endoftext|><|endoftext|><|endoftext|><|endoftext	'ɛn.'dɛn.dəʊf.`tɛk.'stɛn.dəʊf.`tɛk.'stɛn.dəʊf.`tɛk.'stɛn.dəʊf.`tɛk.'stɛn.dəʊf.`tɛk.'stɛn.dəʊf.`tɛk.'stɛn.dəʊf.`tɛk.'stɛn.dəʊf.`tɛk.'stɛn.dəʊf.`tɛk.'stɛn.dəʊf.`tɛkst
thistler	'θɪ.slʌ
thay	'θeɪ
wol	'wɑl
thining	'ðaɪ.nɪŋ
living-people	'lɪ.vɪŋ.'pi.pʌl
thyrsos	'θɪ.ʌ.`səʊz
tlc	`ti.`ɛl.'si
away.<|endoftext|><|endoftext|><|endoftext|><|endoftext|><|endoftext|><|endoftext|><|endoftext|><|endoftext|><|endoftext	ʌ.'weɪ.'ɛn.dəʊf.`tɛk.'stɛn.dəʊf.`tɛk.'stɛn.dəʊf.`tɛk.'stɛn.dəʊf.`tɛk.'stɛn.dəʊf.`tɛk.'stɛn.dəʊf.`tɛk.'stɛn.dəʊf.`tɛk.'stɛn.dəʊf.`tɛk.'stɛn.dəʊf.`tɛkst
rothsen	'ɹɑθ.sʌn
11:27)<|endoftext|><|endoftext|><|endoftext|><|endoftext|><|endoftext|><|endoftext|><|endoftext	ɪ.'lɛ.vʌn.'twɛn.tɪ.'sɛ.vʌ.'nɛn.dəʊf.`tɛk.'stɛn.dəʊf.`tɛk.'stɛn.dəʊf.`tɛk.'stɛn.dəʊf.`tɛk.'stɛn.dəʊf.`tɛk.'stɛn.dəʊf.`tɛk.'stɛn.dəʊf.`tɛkst
monsieur's	mʌs.'jəː.'bæk.slæ.'ʃɛs
trustth	'tɹʌstθ
istván	ɪst.'vɑn
a.b	`eɪ.'bi
risk,<|endoftext|><|endoftext|><|endoftext|><|endoftext|><|endoftext|><|endoftext|><|endoftext|><|endoftext|><|endoftext	'ɹɪ.'skɛn.dəʊf.`tɛk.'stɛn.dəʊf.`tɛk.'stɛn.dəʊf.`tɛk.'stɛn.dəʊf.`tɛk.'stɛn.dəʊf.`tɛk.'stɛn.dəʊf.`tɛk.'stɛn.dəʊf.`tɛk.'stɛn.dəʊf.`tɛk.'stɛn.dəʊf.`tɛkst
sin's	'sɪn.'bæk.slæ.'ʃɛs
38:35)<|endoftext|><|endoftext|><|endoftext|><|endoftext|><|endoftext|><|endoftext|><|endoftext|><|endoftext	'θəː.tɪ.'eɪt.'θəː.tɪ.'faɪ.'vɛn.dəʊf.`tɛk.'stɛn.dəʊf.`tɛk.'stɛn.dəʊf.`tɛk.'stɛn.dəʊf.`tɛk.'stɛn.dəʊf.`tɛk.'stɛn.dəʊf.`tɛk.'stɛn.dəʊf.`tɛk.'stɛn.dəʊf.`tɛkst
faith."2	'feɪθ.'dɑt.bʌk.`slæʃ.'tʉː
iniquitous	ɪ.'nɪ.kwɪ.tʌs
unrighteous	ʌn.'ɹaɪ.tʃʌs
wealthlessness	'wɛlθ.lʌ.snʌs
throne.<|endoftext|><|endoftext|><|endoftext|><|endoftext|><|endoftext|><|endoftext|><|endoftext|><|endoftext|><|endoftext|><|endoftext|><|endoftext|><|endoftext|><|endoftext|><|endoftext|><|endoftext|><|endoftext|><|endoftext	'θɹəʊ.'nɛn.dəʊf.`tɛk.'stɛn.dəʊf.`tɛk.'stɛn.dəʊf.`tɛk.'stɛn.dəʊf.`tɛk.'stɛn.dəʊf.`tɛk.'stɛn.dəʊf.`tɛk.'stɛn.dəʊf.`tɛk.'stɛn.dəʊf.`tɛk.'stɛn.dəʊf.`tɛk.'stɛn.dəʊf.`tɛk.'stɛn.dəʊf.`tɛk.'stɛn.dəʊf.`tɛk.'stɛn.dəʊf.`tɛk.'stɛn.dəʊf.`tɛk.'stɛn.dəʊf.`tɛk.'stɛn.dəʊf.`tɛk.'stɛn.dəʊf.`tɛkst
trespasses	'tɹɛ.spʌ.sɪz
9:18)"then	'naɪ.'neɪ.tin.'bæk.slæʃ.'ðɛn
3)--and	'θɹi.ænd
unbelief.<|endoftext|><|endoftext|><|endoftext|><|endoftext|><|endoftext|><|endoftext|><|endoftext|><|endoftext|><|endoftext|><|endoftext|><|endoftext	ʌn.bɪ.'li.'fɛn.dəʊf.`tɛk.'stɛn.dəʊf.`tɛk.'stɛn.dəʊf.`tɛk.'stɛn.dəʊf.`tɛk.'stɛn.dəʊf.`tɛk.'stɛn.dəʊf.`tɛk.'stɛn.dəʊf.`tɛk.'stɛn.dəʊf.`tɛk.'stɛn.dəʊf.`tɛk.'stɛn.dəʊf.`tɛk.'stɛn.dəʊf.`tɛkst
eusebius	jʉː.'si.bɪ.ʌs
3.15-16)<|endoftext|><|endoftext|><|endoftext|><|endoftext|><|endoftext|><|endoftext	'θɹi.pɔɪn.'twɑn.'faɪv.'dæʃ.'sɪk.sti.'nɛn.dəʊf.`tɛk.'stɛn.dəʊf.`tɛk.'stɛn.dəʊf.`tɛk.'stɛn.dəʊf.`tɛk.'stɛn.dəʊf.`tɛk.'stɛn.dəʊf.`tɛkst
jandaba	dʒæn.'dɑ.bʌ
src	`ɛ.`sɑ.'si
liveeth	'laɪ.vɛθ
wisheth	'wɪ.ʃʌθ
bondage."1	'bɑn.dɪdʒ.'dɑt.bʌk.`slæ.'ʃwɑn
other.<|endoftext|><|endoftext|><|endoftext|><|endoftext|><|endoftext|><|endoftext|><|endoftext|><|endoftext|><|endoftext|><|endoftext|><|endoftext|><|endoftext	'ʌ.ðʌ.'ɛn.dəʊf.`tɛk.'stɛn.dəʊf.`tɛk.'stɛn.dəʊf.`tɛk.'stɛn.dəʊf.`tɛk.'stɛn.dəʊf.`tɛk.'stɛn.dəʊf.`tɛk.'stɛn.dəʊf.`tɛk.'stɛn.dəʊf.`tɛk.'stɛn.dəʊf.`tɛk.'stɛn.dəʊf.`tɛk.'stɛn.dəʊf.`tɛk.'stɛn.dəʊf.`tɛkst
unclean-goat	ʌn.'klin.'ɡəʊt
m)he	'ɛm.hi
harm.<|endoftext|><|endoftext|><|endoftext|><|endoftext|><|endoftext|><|endoftext|><|endoftext|><|endoftext|><|endoftext|><|endoftext|><|endoftext|><|endoftext	'hɑ.'mɛn.dəʊf.`tɛk.'stɛn.dəʊf.`tɛk.'stɛn.dəʊf.`tɛk.'stɛn.dəʊf.`tɛk.'stɛn.dəʊf.`tɛk.'stɛn.dəʊf.`tɛk.'stɛn.dəʊf.`tɛk.'stɛn.dəʊf.`tɛk.'stɛn.dəʊf.`tɛk.'stɛn.dəʊf.`tɛk.'stɛn.dəʊf.`tɛk.'stɛn.dəʊf.`tɛkst
arm."--matthew	'ɑm.'dɑt.bʌk.`slæʃ.'mæ.θjʉː
life."3	'laɪf.'dɑt.bʌk.`slæʃ.'θɹi
live.<|endoftext|><|endoftext|><|endoftext|><|endoftext|><|endoftext|><|endoftext|><|endoftext|><|endoftext|><|endoftext|><|endoftext|><|endoftext|><|endoftext|><|endoftext|><|endoftext	'laɪ.'vɛn.dəʊf.`tɛk.'stɛn.dəʊf.`tɛk.'stɛn.dəʊf.`tɛk.'stɛn.dəʊf.`tɛk.'stɛn.dəʊf.`tɛk.'stɛn.dəʊf.`tɛk.'stɛn.dəʊf.`tɛk.'stɛn.dəʊf.`tɛk.'stɛn.dəʊf.`tɛk.'stɛn.dəʊf.`tɛk.'stɛn.dəʊf.`tɛk.'stɛn.dəʊf.`tɛk.'stɛn.dəʊf.`tɛk.'stɛn.dəʊf.`tɛkst
force.<|endoftext|><|endoftext|><|endoftext|><|endoftext|><|endoftext|><|endoftext|><|endoftext|><|endoftext|><|endoftext|><|endoftext|><|endoftext|><|endoftext|><|endoftext	'fɔː.'sɛn.dəʊf.`tɛk.'stɛn.dəʊf.`tɛk.'stɛn.dəʊf.`tɛk.'stɛn.dəʊf.`tɛk.'stɛn.dəʊf.`tɛk.'stɛn.dəʊf.`tɛk.'stɛn.dəʊf.`tɛk.'stɛn.dəʊf.`tɛk.'stɛn.dəʊf.`tɛk.'stɛn.dəʊf.`tɛk.'stɛn.dəʊf.`tɛk.'stɛn.dəʊf.`tɛk.'stɛn.dəʊf.`tɛkst
oppression,<|endoftext|><|endoftext|><|endoftext|><|endoftext|><|endoftext|><|endoftext|><|endoftext|><|endoftext|><|endoftext|><|endoftext|><|endoftext|><|endoftext|><|endoftext|><|endoftext	ʌ.'pɹɛ.ʃʌ.'nɛn.dəʊf.`tɛk.'stɛn.dəʊf.`tɛk.'stɛn.dəʊf.`tɛk.'stɛn.dəʊf.`tɛk.'stɛn.dəʊf.`tɛk.'stɛn.dəʊf.`tɛk.'stɛn.dəʊf.`tɛk.'stɛn.dəʊf.`tɛk.'stɛn.dəʊf.`tɛk.'stɛn.dəʊf.`tɛk.'stɛn.dəʊf.`tɛk.'stɛn.dəʊf.`tɛk.'stɛn.dəʊf.`tɛk.'stɛn.dəʊf.`tɛkst
rejecteth	ɹɪ.'dʒɛk.tʌθ
l'umberto	'ɛl.'bæk.slæ.'ʃʌm.bʌ.`təʊ
offences	ʌ.'fɛn.sɪz
afar.and	ʌ.'fɑ.'dɑ.tænd
me.<|endoftext|><|endoftext|><|endoftext|><|endoftext|><|endoftext|><|endoftext|><|endoftext|><|endoftext|><|endoftext|><|endoftext	'mi.'ɛn.dəʊf.`tɛk.'stɛn.dəʊf.`tɛk.'stɛn.dəʊf.`tɛk.'stɛn.dəʊf.`tɛk.'stɛn.dəʊf.`tɛk.'stɛn.dəʊf.`tɛk.'stɛn.dəʊf.`tɛk.'stɛn.dəʊf.`tɛk.'stɛn.dəʊf.`tɛk.'stɛn.dəʊf.`tɛkst
behold—i	bɪ.'həʊl.'daɪ
spoke.<|endoftext|><|endoftext|><|endoftext|><|endoftext|><|endoftext|><|endoftext|><|endoftext|><|endoftext	'spəʊ.'kɛn.dəʊf.`tɛk.'stɛn.dəʊf.`tɛk.'stɛn.dəʊf.`tɛk.'stɛn.dəʊf.`tɛk.'stɛn.dəʊf.`tɛk.'stɛn.dəʊf.`tɛk.'stɛn.dəʊf.`tɛk.'stɛn.dəʊf.`tɛkst
gaius	'ɡeɪ.ʌs
mind.and	'maɪnd.'dɑ.tænd
a.m.e.k	`eɪ.`ɛ.`mi.'keɪ
know.<|endoftext|><|endoftext|><|endoftext|><|endoftext|><|endoftext|><|endoftext|><|endoftext|><|endoftext|><|endoftext|><|endoftext|><|endoftext|><|endoftext|><|endoftext|><|endoftext|><|endoftext	'nəʊ.'ɛn.dəʊf.`tɛk.'stɛn.dəʊf.`tɛk.'stɛn.dəʊf.`tɛk.'stɛn.dəʊf.`tɛk.'stɛn.dəʊf.`tɛk.'stɛn.dəʊf.`tɛk.'stɛn.dəʊf.`tɛk.'stɛn.dəʊf.`tɛk.'stɛn.dəʊf.`tɛk.'stɛn.dəʊf.`tɛk.'stɛn.dəʊf.`tɛk.'stɛn.dəʊf.`tɛk.'stɛn.dəʊf.`tɛk.'stɛn.dəʊf.`tɛk.'stɛn.dəʊf.`tɛkst
3)--i	'θɹi.'aɪ
didest	'daɪ.dʌst
behold.<|endoftext|><|endoftext|><|endoftext|><|endoftext|><|endoftext|><|endoftext|><|endoftext|><|endoftext|><|endoftext|><|endoftext|><|endoftext|><|endoftext|><|endoftext|><|endoftext|><|endoftext|><|endoftext|><|endoftext|><|endoftext	bɪ.'həʊl.'dɛn.dəʊf.`tɛk.'stɛn.dəʊf.`tɛk.'stɛn.dəʊf.`tɛk.'stɛn.dəʊf.`tɛk.'stɛn.dəʊf.`tɛk.'stɛn.dəʊf.`tɛk.'stɛn.dəʊf.`tɛk.'stɛn.dəʊf.`tɛk.'stɛn.dəʊf.`tɛk.'stɛn.dəʊf.`tɛk.'stɛn.dəʊf.`tɛk.'stɛn.dəʊf.`tɛk.'stɛn.dəʊf.`tɛk.'stɛn.dəʊf.`tɛk.'stɛn.dəʊf.`tɛk.'stɛn.dəʊf.`tɛk.'stɛn.dəʊf.`tɛk.'stɛn.dəʊf.`tɛkst
upon?"(4	ʌ.`pɑn.'bæk.slæʃ.'fɔː
ocean.<|endoftext|><|endoftext|><|endoftext|><|endoftext|><|endoftext|><|endoftext	'əʊ.ʃʌ.'nɛn.dəʊf.`tɛk.'stɛn.dəʊf.`tɛk.'stɛn.dəʊf.`tɛk.'stɛn.dəʊf.`tɛk.'stɛn.dəʊf.`tɛk.'stɛn.dəʊf.`tɛkst
same.and	'seɪm.'dɑ.tænd
friend.<|endoftext|><|endoftext|><|endoftext|><|endoftext|><|endoftext|><|endoftext|><|endoftext|><|endoftext|><|endoftext|><|endoftext	'fɹɛn.'dɛn.dəʊf.`tɛk.'stɛn.dəʊf.`tɛk.'stɛn.dəʊf.`tɛk.'stɛn.dəʊf.`tɛk.'stɛn.dəʊf.`tɛk.'stɛn.dəʊf.`tɛk.'stɛn.dəʊf.`tɛk.'stɛn.dəʊf.`tɛk.'stɛn.dəʊf.`tɛk.'stɛn.dəʊf.`tɛkst
girdst	'ɡəːdst
out.<|endoftext|><|endoftext|><|endoftext|><|endoftext|><|endoftext|><|endoftext|><|endoftext|><|endoftext|><|endoftext|><|endoftext	'aʊ.'tɛn.dəʊf.`tɛk.'stɛn.dəʊf.`tɛk.'stɛn.dəʊf.`tɛk.'stɛn.dəʊf.`tɛk.'stɛn.dəʊf.`tɛk.'stɛn.dəʊf.`tɛk.'stɛn.dəʊf.`tɛk.'stɛn.dəʊf.`tɛk.'stɛn.dəʊf.`tɛk.'stɛn.dəʊf.`tɛkst
behold--i	bɪ.'həʊl.'daɪ
day.<|endoftext|><|endoftext|><|endoftext|><|endoftext|><|endoftext|><|endoftext|><|endoftext|><|endoftext|><|endoftext|><|endoftext|><|endoftext|><|endoftext|><|endoftext|><|endoftext	'deɪ.'ɛn.dəʊf.`tɛk.'stɛn.dəʊf.`tɛk.'stɛn.dəʊf.`tɛk.'stɛn.dəʊf.`tɛk.'stɛn.dəʊf.`tɛk.'stɛn.dəʊf.`tɛk.'stɛn.dəʊf.`tɛk.'stɛn.dəʊf.`tɛk.'stɛn.dəʊf.`tɛk.'stɛn.dəʊf.`tɛk.'stɛn.dəʊf.`tɛk.'stɛn.dəʊf.`tɛk.'stɛn.dəʊf.`tɛk.'stɛn.dəʊf.`tɛkst
me.and	`mi.'dɑ.tænd
lampt	'læmpt
you.<|endoftext|><|endoftext|><|endoftext|><|endoftext|><|endoftext|><|endoftext|><|endoftext|><|endoftext|><|endoftext|><|endoftext|><|endoftext|><|endoftext|><|endoftext|><|endoftext	'jʉː.'ɛn.dəʊf.`tɛk.'stɛn.dəʊf.`tɛk.'stɛn.dəʊf.`tɛk.'stɛn.dəʊf.`tɛk.'stɛn.dəʊf.`tɛk.'stɛn.dəʊf.`tɛk.'stɛn.dəʊf.`tɛk.'stɛn.dəʊf.`tɛk.'stɛn.dəʊf.`tɛk.'stɛn.dəʊf.`tɛk.'stɛn.dəʊf.`tɛk.'stɛn.dəʊf.`tɛk.'stɛn.dəʊf.`tɛk.'stɛn.dəʊf.`tɛkst
voice.<|endoftext|><|endoftext|><|endoftext|><|endoftext|><|endoftext|><|endoftext|><|endoftext|><|endoftext|><|endoftext|><|endoftext|><|endoftext|><|endoftext	'vɔɪ.'sɛn.dəʊf.`tɛk.'stɛn.dəʊf.`tɛk.'stɛn.dəʊf.`tɛk.'stɛn.dəʊf.`tɛk.'stɛn.dəʊf.`tɛk.'stɛn.dəʊf.`tɛk.'stɛn.dəʊf.`tɛk.'stɛn.dəʊf.`tɛk.'stɛn.dəʊf.`tɛk.'stɛn.dəʊf.`tɛk.'stɛn.dəʊf.`tɛk.'stɛn.dəʊf.`tɛkst
truth.i	'tɹʉːθ.'dɑ.'taɪ
knees.and	'niz.'dɑ.tænd
saying.<|endoftext|><|endoftext|><|endoftext|><|endoftext|><|endoftext|><|endoftext|><|endoftext|><|endoftext|><|endoftext|><|endoftext|><|endoftext|><|endoftext|><|endoftext|><|endoftext	'seɪ.ɪŋ.'ɛn.dəʊf.`tɛk.'stɛn.dəʊf.`tɛk.'stɛn.dəʊf.`tɛk.'stɛn.dəʊf.`tɛk.'stɛn.dəʊf.`tɛk.'stɛn.dəʊf.`tɛk.'stɛn.dəʊf.`tɛk.'stɛn.dəʊf.`tɛk.'stɛn.dəʊf.`tɛk.'stɛn.dəʊf.`tɛk.'stɛn.dəʊf.`tɛk.'stɛn.dəʊf.`tɛk.'stɛn.dəʊf.`tɛk.'stɛn.dəʊf.`tɛkst
words.i	'wəːdz.'dɑ.'taɪ
ear.and	'eɪ.ʌ.'dɑ.tænd
thousandfold	'θaʊ.zʌnd.`fəʊld
on.for	`ɑn.'dɑt.fɔː
ﷺ	
speak.<|endoftext|><|endoftext|><|endoftext|><|endoftext|><|endoftext|><|endoftext|><|endoftext|><|endoftext|><|endoftext|><|endoftext	'spi.'kɛn.dəʊf.`tɛk.'stɛn.dəʊf.`tɛk.'stɛn.dəʊf.`tɛk.'stɛn.dəʊf.`tɛk.'stɛn.dəʊf.`tɛk.'stɛn.dəʊf.`tɛk.'stɛn.dəʊf.`tɛk.'stɛn.dəʊf.`tɛk.'stɛn.dəʊf.`tɛk.'stɛn.dəʊf.`tɛkst
you.<|endoftext|><|endoftext|><|endoftext|><|endoftext|><|endoftext|><|endoftext|><|endoftext|><|endoftext|><|endoftext	'jʉː.'ɛn.dəʊf.`tɛk.'stɛn.dəʊf.`tɛk.'stɛn.dəʊf.`tɛk.'stɛn.dəʊf.`tɛk.'stɛn.dəʊf.`tɛk.'stɛn.dəʊf.`tɛk.'stɛn.dəʊf.`tɛk.'stɛn.dəʊf.`tɛk.'stɛn.dəʊf.`tɛkst
christ.<|endoftext|><|endoftext|><|endoftext|><|endoftext|><|endoftext|><|endoftext|><|endoftext|><|endoftext|><|endoftext|><|endoftext|><|endoftext	'kɹaɪ.'stɛn.dəʊf.`tɛk.'stɛn.dəʊf.`tɛk.'stɛn.dəʊf.`tɛk.'stɛn.dəʊf.`tɛk.'stɛn.dəʊf.`tɛk.'stɛn.dəʊf.`tɛk.'stɛn.dəʊf.`tɛk.'stɛn.dəʊf.`tɛk.'stɛn.dəʊf.`tɛk.'stɛn.dəʊf.`tɛk.'stɛn.dəʊf.`tɛkst
proudness	'pɹaʊd.nʌs
shabbos	'ʃæ.bəʊz
quickidious	kwɪ.'kɪ.dɪ.ʌs
bride-cake's	'bɹaɪd.'keɪk.'bæk.slæ.'ʃɛs
iwring	'ɪ.ɹɪŋ
half-bred	'hɑf.'bɹɛd
hept	'hɛpt
d.g.s.e	`di.`dʒi.`ɛ.'si
wifehood	'waɪf.hʊəd
23	'twɛn.tɪ.'θɹi
wife.<|endoftext|><|endoftext|><|endoftext|><|endoftext|><|endoftext|><|endoftext|><|endoftext|><|endoftext|><|endoftext|><|endoftext|><|endoftext|><|endoftext|><|endoftext	'waɪ.'fɛn.dəʊf.`tɛk.'stɛn.dəʊf.`tɛk.'stɛn.dəʊf.`tɛk.'stɛn.dəʊf.`tɛk.'stɛn.dəʊf.`tɛk.'stɛn.dəʊf.`tɛk.'stɛn.dəʊf.`tɛk.'stɛn.dəʊf.`tɛk.'stɛn.dəʊf.`tɛk.'stɛn.dəʊf.`tɛk.'stɛn.dəʊf.`tɛk.'stɛn.dəʊf.`tɛk.'stɛn.dəʊf.`tɛkst
maidensmaid	'meɪ.dʌn.`smeɪd
deceived!—my	dɪ.'sivd.'maɪ
ever-living	'ɛ.vʌ.'lɪ.vɪŋ
words:<|endoftext|><|endoftext|><|endoftext|><|endoftext|><|endoftext|><|endoftext|><|endoftext|><|endoftext|><|endoftext|><|endoftext	'wəːd.'zɛn.dəʊf.`tɛk.'stɛn.dəʊf.`tɛk.'stɛn.dəʊf.`tɛk.'stɛn.dəʊf.`tɛk.'stɛn.dəʊf.`tɛk.'stɛn.dəʊf.`tɛk.'stɛn.dəʊf.`tɛk.'stɛn.dəʊf.`tɛk.'stɛn.dəʊf.`tɛk.'stɛn.dəʊf.`tɛkst
seeeth	'si.ɛθ
begetest	bɪ.'ɡɛ.tʌst
high-altar	'haɪ.'ɑl.tʌ
19:1-10.)<|endoftext	'naɪn.tin.'kəʊ.lʌn.'wɑn.'dæʃ.'tɛ.'nɛn.dəʊf.`tɛkst
twixt	'twɪkst
love-kindling	'lʌv.'kɪnd.lɪŋ
i-ii	aɪ.`ɹəʊ.mʌn.'tʉː
bhikkhu	'bɪ.kʉː
light.<|endoftext|><|endoftext|><|endoftext|><|endoftext|><|endoftext|><|endoftext|><|endoftext|><|endoftext|><|endoftext|><|endoftext|><|endoftext|><|endoftext|><|endoftext|><|endoftext|><|endoftext	'laɪ.'tɛn.dəʊf.`tɛk.'stɛn.dəʊf.`tɛk.'stɛn.dəʊf.`tɛk.'stɛn.dəʊf.`tɛk.'stɛn.dəʊf.`tɛk.'stɛn.dəʊf.`tɛk.'stɛn.dəʊf.`tɛk.'stɛn.dəʊf.`tɛk.'stɛn.dəʊf.`tɛk.'stɛn.dəʊf.`tɛk.'stɛn.dəʊf.`tɛk.'stɛn.dəʊf.`tɛk.'stɛn.dəʊf.`tɛk.'stɛn.dəʊf.`tɛk.'stɛn.dəʊf.`tɛkst
dwells.<|endoftext|><|endoftext|><|endoftext|><|endoftext|><|endoftext|><|endoftext|><|endoftext|><|endoftext|><|endoftext|><|endoftext|><|endoftext|><|endoftext|><|endoftext	'dwɛl.'zɛn.dəʊf.`tɛk.'stɛn.dəʊf.`tɛk.'stɛn.dəʊf.`tɛk.'stɛn.dəʊf.`tɛk.'stɛn.dəʊf.`tɛk.'stɛn.dəʊf.`tɛk.'stɛn.dəʊf.`tɛk.'stɛn.dəʊf.`tɛk.'stɛn.dəʊf.`tɛk.'stɛn.dəʊf.`tɛk.'stɛn.dəʊf.`tɛk.'stɛn.dəʊf.`tɛk.'stɛn.dəʊf.`tɛkst
more.<|endoftext|><|endoftext|><|endoftext|><|endoftext|><|endoftext|><|endoftext|><|endoftext|><|endoftext|><|endoftext|><|endoftext|><|endoftext|><|endoftext|><|endoftext	'mɔː.'ɛn.dəʊf.`tɛk.'stɛn.dəʊf.`tɛk.'stɛn.dəʊf.`tɛk.'stɛn.dəʊf.`tɛk.'stɛn.dəʊf.`tɛk.'stɛn.dəʊf.`tɛk.'stɛn.dəʊf.`tɛk.'stɛn.dəʊf.`tɛk.'stɛn.dəʊf.`tɛk.'stɛn.dəʊf.`tɛk.'stɛn.dəʊf.`tɛk.'stɛn.dəʊf.`tɛk.'stɛn.dəʊf.`tɛkst
ever.<|endoftext|><|endoftext|><|endoftext|><|endoftext|><|endoftext|><|endoftext|><|endoftext|><|endoftext|><|endoftext|><|endoftext	'ɛ.vʌ.'ɛn.dəʊf.`tɛk.'stɛn.dəʊf.`tɛk.'stɛn.dəʊf.`tɛk.'stɛn.dəʊf.`tɛk.'stɛn.dəʊf.`tɛk.'stɛn.dəʊf.`tɛk.'stɛn.dəʊf.`tɛk.'stɛn.dəʊf.`tɛk.'stɛn.dəʊf.`tɛk.'stɛn.dəʊf.`tɛkst
hell.<|endoftext|><|endoftext|><|endoftext|><|endoftext|><|endoftext|><|endoftext|><|endoftext|><|endoftext|><|endoftext|><|endoftext|><|endoftext|><|endoftext|><|endoftext|><|endoftext|><|endoftext|><|endoftext|><|endoftext	'hɛ.'lɛn.dəʊf.`tɛk.'stɛn.dəʊf.`tɛk.'stɛn.dəʊf.`tɛk.'stɛn.dəʊf.`tɛk.'stɛn.dəʊf.`tɛk.'stɛn.dəʊf.`tɛk.'stɛn.dəʊf.`tɛk.'stɛn.dəʊf.`tɛk.'stɛn.dəʊf.`tɛk.'stɛn.dəʊf.`tɛk.'stɛn.dəʊf.`tɛk.'stɛn.dəʊf.`tɛk.'stɛn.dəʊf.`tɛk.'stɛn.dəʊf.`tɛk.'stɛn.dəʊf.`tɛk.'stɛn.dəʊf.`tɛk.'stɛn.dəʊf.`tɛkst
void.<|endoftext|><|endoftext|><|endoftext|><|endoftext|><|endoftext|><|endoftext|><|endoftext|><|endoftext|><|endoftext|><|endoftext|><|endoftext	'vɔɪ.'dɛn.dəʊf.`tɛk.'stɛn.dəʊf.`tɛk.'stɛn.dəʊf.`tɛk.'stɛn.dəʊf.`tɛk.'stɛn.dəʊf.`tɛk.'stɛn.dəʊf.`tɛk.'stɛn.dəʊf.`tɛk.'stɛn.dəʊf.`tɛk.'stɛn.dəʊf.`tɛk.'stɛn.dəʊf.`tɛk.'stɛn.dəʊf.`tɛkst
earth.<|endoftext|><|endoftext|><|endoftext|><|endoftext|><|endoftext|><|endoftext|><|endoftext|><|endoftext|><|endoftext|><|endoftext|><|endoftext|><|endoftext|><|endoftext	'əː.'θɛn.dəʊf.`tɛk.'stɛn.dəʊf.`tɛk.'stɛn.dəʊf.`tɛk.'stɛn.dəʊf.`tɛk.'stɛn.dəʊf.`tɛk.'stɛn.dəʊf.`tɛk.'stɛn.dəʊf.`tɛk.'stɛn.dəʊf.`tɛk.'stɛn.dəʊf.`tɛk.'stɛn.dəʊf.`tɛk.'stɛn.dəʊf.`tɛk.'stɛn.dəʊf.`tɛk.'stɛn.dəʊf.`tɛkst
sleep.<|endoftext|><|endoftext|><|endoftext|><|endoftext|><|endoftext|><|endoftext	'sli.'pɛn.dəʊf.`tɛk.'stɛn.dəʊf.`tɛk.'stɛn.dəʊf.`tɛk.'stɛn.dəʊf.`tɛk.'stɛn.dəʊf.`tɛk.'stɛn.dəʊf.`tɛkst
pseudo-chrys	'sʉː.dəʊ.'kɹaɪz
it.<|endoftext|><|endoftext|><|endoftext|><|endoftext|><|endoftext|><|endoftext|><|endoftext|><|endoftext|><|endoftext|><|endoftext|><|endoftext|><|endoftext|><|endoftext	'ɪ.'tɛn.dəʊf.`tɛk.'stɛn.dəʊf.`tɛk.'stɛn.dəʊf.`tɛk.'stɛn.dəʊf.`tɛk.'stɛn.dəʊf.`tɛk.'stɛn.dəʊf.`tɛk.'stɛn.dəʊf.`tɛk.'stɛn.dəʊf.`tɛk.'stɛn.dəʊf.`tɛk.'stɛn.dəʊf.`tɛk.'stɛn.dəʊf.`tɛk.'stɛn.dəʊf.`tɛk.'stɛn.dəʊf.`tɛkst
it.<|endoftext|><|endoftext|><|endoftext|><|endoftext|><|endoftext|><|endoftext|><|endoftext|><|endoftext	'ɪ.'tɛn.dəʊf.`tɛk.'stɛn.dəʊf.`tɛk.'stɛn.dəʊf.`tɛk.'stɛn.dəʊf.`tɛk.'stɛn.dəʊf.`tɛk.'stɛn.dəʊf.`tɛk.'stɛn.dəʊf.`tɛk.'stɛn.dəʊf.`tɛkst
loss—do	'lɑs.'dʉː
again.<|endoftext|><|endoftext|><|endoftext|><|endoftext|><|endoftext|><|endoftext|><|endoftext|><|endoftext|><|endoftext|><|endoftext|><|endoftext|><|endoftext|><|endoftext|><|endoftext|><|endoftext	ʌ.'ɡɛ.'nɛn.dəʊf.`tɛk.'stɛn.dəʊf.`tɛk.'stɛn.dəʊf.`tɛk.'stɛn.dəʊf.`tɛk.'stɛn.dəʊf.`tɛk.'stɛn.dəʊf.`tɛk.'stɛn.dəʊf.`tɛk.'stɛn.dəʊf.`tɛk.'stɛn.dəʊf.`tɛk.'stɛn.dəʊf.`tɛk.'stɛn.dəʊf.`tɛk.'stɛn.dəʊf.`tɛk.'stɛn.dəʊf.`tɛk.'stɛn.dəʊf.`tɛk.'stɛn.dəʊf.`tɛkst
forever,<|endoftext|><|endoftext|><|endoftext|><|endoftext|><|endoftext|><|endoftext|><|endoftext|><|endoftext|><|endoftext|><|endoftext|><|endoftext|><|endoftext|><|endoftext|><|endoftext|><|endoftext	fʌ.'ɹɛ.vʌ.'ɛn.dəʊf.`tɛk.'stɛn.dəʊf.`tɛk.'stɛn.dəʊf.`tɛk.'stɛn.dəʊf.`tɛk.'stɛn.dəʊf.`tɛk.'stɛn.dəʊf.`tɛk.'stɛn.dəʊf.`tɛk.'stɛn.dəʊf.`tɛk.'stɛn.dəʊf.`tɛk.'stɛn.dəʊf.`tɛk.'stɛn.dəʊf.`tɛk.'stɛn.dəʊf.`tɛk.'stɛn.dəʊf.`tɛk.'stɛn.dəʊf.`tɛk.'stɛn.dəʊf.`tɛkst
unseen.<|endoftext|><|endoftext|><|endoftext|><|endoftext|><|endoftext|><|endoftext|><|endoftext|><|endoftext|><|endoftext|><|endoftext|><|endoftext|><|endoftext|><|endoftext|><|endoftext|><|endoftext	ʌn.'si.'nɛn.dəʊf.`tɛk.'stɛn.dəʊf.`tɛk.'stɛn.dəʊf.`tɛk.'stɛn.dəʊf.`tɛk.'stɛn.dəʊf.`tɛk.'stɛn.dəʊf.`tɛk.'stɛn.dəʊf.`tɛk.'stɛn.dəʊf.`tɛk.'stɛn.dəʊf.`tɛk.'stɛn.dəʊf.`tɛk.'stɛn.dəʊf.`tɛk.'stɛn.dəʊf.`tɛk.'stɛn.dəʊf.`tɛk.'stɛn.dəʊf.`tɛk.'stɛn.dəʊf.`tɛkst
sight.<|endoftext|><|endoftext|><|endoftext|><|endoftext|><|endoftext|><|endoftext|><|endoftext|><|endoftext|><|endoftext|><|endoftext|><|endoftext|><|endoftext|><|endoftext|><|endoftext	'saɪ.'tɛn.dəʊf.`tɛk.'stɛn.dəʊf.`tɛk.'stɛn.dəʊf.`tɛk.'stɛn.dəʊf.`tɛk.'stɛn.dəʊf.`tɛk.'stɛn.dəʊf.`tɛk.'stɛn.dəʊf.`tɛk.'stɛn.dəʊf.`tɛk.'stɛn.dəʊf.`tɛk.'stɛn.dəʊf.`tɛk.'stɛn.dəʊf.`tɛk.'stɛn.dəʊf.`tɛk.'stɛn.dəʊf.`tɛk.'stɛn.dəʊf.`tɛkst
fidea	'faɪ.deɪ.ʌ
name.<|endoftext|><|endoftext|><|endoftext|><|endoftext|><|endoftext|><|endoftext|><|endoftext|><|endoftext|><|endoftext|><|endoftext|><|endoftext|><|endoftext|><|endoftext|><|endoftext|><|endoftext|><|endoftext	'neɪ.'mɛn.dəʊf.`tɛk.'stɛn.dəʊf.`tɛk.'stɛn.dəʊf.`tɛk.'stɛn.dəʊf.`tɛk.'stɛn.dəʊf.`tɛk.'stɛn.dəʊf.`tɛk.'stɛn.dəʊf.`tɛk.'stɛn.dəʊf.`tɛk.'stɛn.dəʊf.`tɛk.'stɛn.dəʊf.`tɛk.'stɛn.dəʊf.`tɛk.'stɛn.dəʊf.`tɛk.'stɛn.dəʊf.`tɛk.'stɛn.dəʊf.`tɛk.'stɛn.dəʊf.`tɛk.'stɛn.dəʊf.`tɛkst
forever.<|endoftext|><|endoftext|><|endoftext|><|endoftext|><|endoftext|><|endoftext|><|endoftext|><|endoftext|><|endoftext|><|endoftext|><|endoftext|><|endoftext|><|endoftext|><|endoftext|><|endoftext	fʌ.'ɹɛ.vʌ.'ɛn.dəʊf.`tɛk.'stɛn.dəʊf.`tɛk.'stɛn.dəʊf.`tɛk.'stɛn.dəʊf.`tɛk.'stɛn.dəʊf.`tɛk.'stɛn.dəʊf.`tɛk.'stɛn.dəʊf.`tɛk.'stɛn.dəʊf.`tɛk.'stɛn.dəʊf.`tɛk.'stɛn.dəʊf.`tɛk.'stɛn.dəʊf.`tɛk.'stɛn.dəʊf.`tɛk.'stɛn.dəʊf.`tɛk.'stɛn.dəʊf.`tɛk.'stɛn.dəʊf.`tɛkst
pg-pg	`pi.'dʒi.`pi.'dʒi
man.—a	'mæ.'neɪ
way.<|endoftext|><|endoftext|><|endoftext|><|endoftext|><|endoftext|><|endoftext|><|endoftext|><|endoftext|><|endoftext|><|endoftext|><|endoftext|><|endoftext|><|endoftext|><|endoftext|><|endoftext	'weɪ.'ɛn.dəʊf.`tɛk.'stɛn.dəʊf.`tɛk.'stɛn.dəʊf.`tɛk.'stɛn.dəʊf.`tɛk.'stɛn.dəʊf.`tɛk.'stɛn.dəʊf.`tɛk.'stɛn.dəʊf.`tɛk.'stɛn.dəʊf.`tɛk.'stɛn.dəʊf.`tɛk.'stɛn.dəʊf.`tɛk.'stɛn.dəʊf.`tɛk.'stɛn.dəʊf.`tɛk.'stɛn.dəʊf.`tɛk.'stɛn.dəʊf.`tɛk.'stɛn.dəʊf.`tɛkst
ever.<|endoftext|><|endoftext|><|endoftext|><|endoftext|><|endoftext|><|endoftext|><|endoftext|><|endoftext|><|endoftext|><|endoftext|><|endoftext|><|endoftext|><|endoftext|><|endoftext|><|endoftext|><|endoftext	'ɛ.vʌ.'ɛn.dəʊf.`tɛk.'stɛn.dəʊf.`tɛk.'stɛn.dəʊf.`tɛk.'stɛn.dəʊf.`tɛk.'stɛn.dəʊf.`tɛk.'stɛn.dəʊf.`tɛk.'stɛn.dəʊf.`tɛk.'stɛn.dəʊf.`tɛk.'stɛn.dəʊf.`tɛk.'stɛn.dəʊf.`tɛk.'stɛn.dəʊf.`tɛk.'stɛn.dəʊf.`tɛk.'stɛn.dəʊf.`tɛk.'stɛn.dəʊf.`tɛk.'stɛn.dəʊf.`tɛk.'stɛn.dəʊf.`tɛkst
ages.<|endoftext|><|endoftext|><|endoftext|><|endoftext|><|endoftext|><|endoftext|><|endoftext|><|endoftext|><|endoftext|><|endoftext|><|endoftext|><|endoftext|><|endoftext|><|endoftext	'eɪ.dʒɪ.'zɛn.dəʊf.`tɛk.'stɛn.dəʊf.`tɛk.'stɛn.dəʊf.`tɛk.'stɛn.dəʊf.`tɛk.'stɛn.dəʊf.`tɛk.'stɛn.dəʊf.`tɛk.'stɛn.dəʊf.`tɛk.'stɛn.dəʊf.`tɛk.'stɛn.dəʊf.`tɛk.'stɛn.dəʊf.`tɛk.'stɛn.dəʊf.`tɛk.'stɛn.dəʊf.`tɛk.'stɛn.dəʊf.`tɛk.'stɛn.dəʊf.`tɛkst
time.<|endoftext|><|endoftext|><|endoftext|><|endoftext|><|endoftext|><|endoftext|><|endoftext|><|endoftext|><|endoftext|><|endoftext|><|endoftext|><|endoftext|><|endoftext|><|endoftext|><|endoftext|><|endoftext	'taɪ.'mɛn.dəʊf.`tɛk.'stɛn.dəʊf.`tɛk.'stɛn.dəʊf.`tɛk.'stɛn.dəʊf.`tɛk.'stɛn.dəʊf.`tɛk.'stɛn.dəʊf.`tɛk.'stɛn.dəʊf.`tɛk.'stɛn.dəʊf.`tɛk.'stɛn.dəʊf.`tɛk.'stɛn.dəʊf.`tɛk.'stɛn.dəʊf.`tɛk.'stɛn.dəʊf.`tɛk.'stɛn.dəʊf.`tɛk.'stɛn.dəʊf.`tɛk.'stɛn.dəʊf.`tɛk.'stɛn.dəʊf.`tɛkst
place.<|endoftext|><|endoftext|><|endoftext|><|endoftext|><|endoftext|><|endoftext|><|endoftext|><|endoftext|><|endoftext|><|endoftext|><|endoftext|><|endoftext|><|endoftext|><|endoftext	'pleɪ.'sɛn.dəʊf.`tɛk.'stɛn.dəʊf.`tɛk.'stɛn.dəʊf.`tɛk.'stɛn.dəʊf.`tɛk.'stɛn.dəʊf.`tɛk.'stɛn.dəʊf.`tɛk.'stɛn.dəʊf.`tɛk.'stɛn.dəʊf.`tɛk.'stɛn.dəʊf.`tɛk.'stɛn.dəʊf.`tɛk.'stɛn.dəʊf.`tɛk.'stɛn.dəʊf.`tɛk.'stɛn.dəʊf.`tɛk.'stɛn.dəʊf.`tɛkst
seen:<|endoftext|><|endoftext|><|endoftext|><|endoftext|><|endoftext|><|endoftext|><|endoftext|><|endoftext|><|endoftext|><|endoftext|><|endoftext|><|endoftext|><|endoftext|><|endoftext|><|endoftext	'si.'nɛn.dəʊf.`tɛk.'stɛn.dəʊf.`tɛk.'stɛn.dəʊf.`tɛk.'stɛn.dəʊf.`tɛk.'stɛn.dəʊf.`tɛk.'stɛn.dəʊf.`tɛk.'stɛn.dəʊf.`tɛk.'stɛn.dəʊf.`tɛk.'stɛn.dəʊf.`tɛk.'stɛn.dəʊf.`tɛk.'stɛn.dəʊf.`tɛk.'stɛn.dəʊf.`tɛk.'stɛn.dəʊf.`tɛk.'stɛn.dəʊf.`tɛk.'stɛn.dəʊf.`tɛkst
xlii	`ɹəʊ.mʌn.'fɔː.tɪ.'tʉː
darkness.<|endoftext|><|endoftext|><|endoftext|><|endoftext|><|endoftext|><|endoftext|><|endoftext|><|endoftext|><|endoftext|><|endoftext|><|endoftext|><|endoftext|><|endoftext|><|endoftext|><|endoftext|><|endoftext	'dɑk.nʌ.'sɛn.dəʊf.`tɛk.'stɛn.dəʊf.`tɛk.'stɛn.dəʊf.`tɛk.'stɛn.dəʊf.`tɛk.'stɛn.dəʊf.`tɛk.'stɛn.dəʊf.`tɛk.'stɛn.dəʊf.`tɛk.'stɛn.dəʊf.`tɛk.'stɛn.dəʊf.`tɛk.'stɛn.dəʊf.`tɛk.'stɛn.dəʊf.`tɛk.'stɛn.dəʊf.`tɛk.'stɛn.dəʊf.`tɛk.'stɛn.dəʊf.`tɛk.'stɛn.dəʊf.`tɛk.'stɛn.dəʊf.`tɛkst
smoke.<|endoftext|><|endoftext|><|endoftext|><|endoftext|><|endoftext|><|endoftext|><|endoftext|><|endoftext|><|endoftext|><|endoftext|><|endoftext|><|endoftext|><|endoftext|><|endoftext	'sməʊ.'kɛn.dəʊf.`tɛk.'stɛn.dəʊf.`tɛk.'stɛn.dəʊf.`tɛk.'stɛn.dəʊf.`tɛk.'stɛn.dəʊf.`tɛk.'stɛn.dəʊf.`tɛk.'stɛn.dəʊf.`tɛk.'stɛn.dəʊf.`tɛk.'stɛn.dəʊf.`tɛk.'stɛn.dəʊf.`tɛk.'stɛn.dəʊf.`tɛk.'stɛn.dəʊf.`tɛk.'stɛn.dəʊf.`tɛk.'stɛn.dəʊf.`tɛkst
world.<|endoftext|><|endoftext|><|endoftext|><|endoftext|><|endoftext|><|endoftext|><|endoftext|><|endoftext|><|endoftext|><|endoftext|><|endoftext|><|endoftext|><|endoftext|><|endoftext|><|endoftext	'wəːl.'dɛn.dəʊf.`tɛk.'stɛn.dəʊf.`tɛk.'stɛn.dəʊf.`tɛk.'stɛn.dəʊf.`tɛk.'stɛn.dəʊf.`tɛk.'stɛn.dəʊf.`tɛk.'stɛn.dəʊf.`tɛk.'stɛn.dəʊf.`tɛk.'stɛn.dəʊf.`tɛk.'stɛn.dəʊf.`tɛk.'stɛn.dəʊf.`tɛk.'stɛn.dəʊf.`tɛk.'stɛn.dəʊf.`tɛk.'stɛn.dəʊf.`tɛk.'stɛn.dəʊf.`tɛkst
xxi	`ɹəʊ.mʌn.'twɛn.tɪ.'wɑn
endoftext|><|endoftext|><|endoftext|><|endoftext|><|endoftext|><|endoftext|><|endoftext|><|endoftext|><|endoftext|><|endoftext|><|endoftext|><|endoftext	'ɛn.dəʊf.`tɛk.'stɛn.dəʊf.`tɛk.'stɛn.dəʊf.`tɛk.'stɛn.dəʊf.`tɛk.'stɛn.dəʊf.`tɛk.'stɛn.dəʊf.`tɛk.'stɛn.dəʊf.`tɛk.'stɛn.dəʊf.`tɛk.'stɛn.dəʊf.`tɛk.'stɛn.dəʊf.`tɛk.'stɛn.dəʊf.`tɛk.'stɛn.dəʊf.`tɛkst
death—the	'dɛθ.ðʌ
trembled.<|endoftext|><|endoftext|><|endoftext|><|endoftext|><|endoftext|><|endoftext|><|endoftext|><|endoftext|><|endoftext	'tɹɛm.bʌl.'dɛn.dəʊf.`tɛk.'stɛn.dəʊf.`tɛk.'stɛn.dəʊf.`tɛk.'stɛn.dəʊf.`tɛk.'stɛn.dəʊf.`tɛk.'stɛn.dəʊf.`tɛk.'stɛn.dəʊf.`tɛk.'stɛn.dəʊf.`tɛk.'stɛn.dəʊf.`tɛkst
daylight.<|endoftext|><|endoftext|><|endoftext|><|endoftext|><|endoftext|><|endoftext|><|endoftext|><|endoftext	'deɪ.laɪ.'tɛn.dəʊf.`tɛk.'stɛn.dəʊf.`tɛk.'stɛn.dəʊf.`tɛk.'stɛn.dəʊf.`tɛk.'stɛn.dəʊf.`tɛk.'stɛn.dəʊf.`tɛk.'stɛn.dəʊf.`tɛk.'stɛn.dəʊf.`tɛkst
it.<|endoftext|><|endoftext|><|endoftext|><|endoftext|><|endoftext|><|endoftext|><|endoftext|><|endoftext|><|endoftext|><|endoftext|><|endoftext|><|endoftext|><|endoftext|><|endoftext|><|endoftext	'ɪ.'tɛn.dəʊf.`tɛk.'stɛn.dəʊf.`tɛk.'stɛn.dəʊf.`tɛk.'stɛn.dəʊf.`tɛk.'stɛn.dəʊf.`tɛk.'stɛn.dəʊf.`tɛk.'stɛn.dəʊf.`tɛk.'stɛn.dəʊf.`tɛk.'stɛn.dəʊf.`tɛk.'stɛn.dəʊf.`tɛk.'stɛn.dəʊf.`tɛk.'stɛn.dəʊf.`tɛk.'stɛn.dəʊf.`tɛk.'stɛn.dəʊf.`tɛk.'stɛn.dəʊf.`tɛkst
light!<|endoftext|><|endoftext|><|endoftext|><|endoftext|><|endoftext|><|endoftext|><|endoftext|><|endoftext|><|endoftext|><|endoftext|><|endoftext|><|endoftext|><|endoftext|><|endoftext|><|endoftext	'laɪ.'tɛn.dəʊf.`tɛk.'stɛn.dəʊf.`tɛk.'stɛn.dəʊf.`tɛk.'stɛn.dəʊf.`tɛk.'stɛn.dəʊf.`tɛk.'stɛn.dəʊf.`tɛk.'stɛn.dəʊf.`tɛk.'stɛn.dəʊf.`tɛk.'stɛn.dəʊf.`tɛk.'stɛn.dəʊf.`tɛk.'stɛn.dəʊf.`tɛk.'stɛn.dəʊf.`tɛk.'stɛn.dəʊf.`tɛk.'stɛn.dəʊf.`tɛk.'stɛn.dəʊf.`tɛkst
more.<|endoftext|><|endoftext|><|endoftext|><|endoftext|><|endoftext|><|endoftext|><|endoftext|><|endoftext|><|endoftext|><|endoftext|><|endoftext|><|endoftext|><|endoftext|><|endoftext|><|endoftext	'mɔː.'ɛn.dəʊf.`tɛk.'stɛn.dəʊf.`tɛk.'stɛn.dəʊf.`tɛk.'stɛn.dəʊf.`tɛk.'stɛn.dəʊf.`tɛk.'stɛn.dəʊf.`tɛk.'stɛn.dəʊf.`tɛk.'stɛn.dəʊf.`tɛk.'stɛn.dəʊf.`tɛk.'stɛn.dəʊf.`tɛk.'stɛn.dəʊf.`tɛk.'stɛn.dəʊf.`tɛk.'stɛn.dəʊf.`tɛk.'stɛn.dəʊf.`tɛk.'stɛn.dəʊf.`tɛkst
darkness.<|endoftext|><|endoftext|><|endoftext|><|endoftext|><|endoftext|><|endoftext|><|endoftext|><|endoftext|><|endoftext|><|endoftext|><|endoftext|><|endoftext|><|endoftext|><|endoftext	'dɑk.nʌ.'sɛn.dəʊf.`tɛk.'stɛn.dəʊf.`tɛk.'stɛn.dəʊf.`tɛk.'stɛn.dəʊf.`tɛk.'stɛn.dəʊf.`tɛk.'stɛn.dəʊf.`tɛk.'stɛn.dəʊf.`tɛk.'stɛn.dəʊf.`tɛk.'stɛn.dəʊf.`tɛk.'stɛn.dəʊf.`tɛk.'stɛn.dəʊf.`tɛk.'stɛn.dəʊf.`tɛk.'stɛn.dəʊf.`tɛk.'stɛn.dəʊf.`tɛkst
corner.<|endoftext|><|endoftext|><|endoftext|><|endoftext|><|endoftext|><|endoftext|><|endoftext|><|endoftext|><|endoftext|><|endoftext|><|endoftext|><|endoftext	'kɔː.nʌ.'ɛn.dəʊf.`tɛk.'stɛn.dəʊf.`tɛk.'stɛn.dəʊf.`tɛk.'stɛn.dəʊf.`tɛk.'stɛn.dəʊf.`tɛk.'stɛn.dəʊf.`tɛk.'stɛn.dəʊf.`tɛk.'stɛn.dəʊf.`tɛk.'stɛn.dəʊf.`tɛk.'stɛn.dəʊf.`tɛk.'stɛn.dəʊf.`tɛk.'stɛn.dəʊf.`tɛkst
hide.<|endoftext|><|endoftext|><|endoftext|><|endoftext|><|endoftext|><|endoftext|><|endoftext|><|endoftext|><|endoftext	'haɪ.'dɛn.dəʊf.`tɛk.'stɛn.dəʊf.`tɛk.'stɛn.dəʊf.`tɛk.'stɛn.dəʊf.`tɛk.'stɛn.dəʊf.`tɛk.'stɛn.dəʊf.`tɛk.'stɛn.dəʊf.`tɛk.'stɛn.dəʊf.`tɛk.'stɛn.dəʊf.`tɛkst
walk—the	'wɔːk.ðʌ
stand—the	'stænd.ðʌ
darkness.​—genesis	'dɑk.nʌs.'dʒɛ.nɪ.`sɪs
shine.<|endoftext|><|endoftext|><|endoftext|><|endoftext|><|endoftext|><|endoftext|><|endoftext|><|endoftext|><|endoftext|><|endoftext|><|endoftext	'ʃaɪ.'nɛn.dəʊf.`tɛk.'stɛn.dəʊf.`tɛk.'stɛn.dəʊf.`tɛk.'stɛn.dəʊf.`tɛk.'stɛn.dəʊf.`tɛk.'stɛn.dəʊf.`tɛk.'stɛn.dəʊf.`tɛk.'stɛn.dəʊf.`tɛk.'stɛn.dəʊf.`tɛk.'stɛn.dəʊf.`tɛk.'stɛn.dəʊf.`tɛkst
snake.<|endoftext|><|endoftext|><|endoftext|><|endoftext|><|endoftext|><|endoftext|><|endoftext|><|endoftext|><|endoftext|><|endoftext|><|endoftext|><|endoftext|><|endoftext|><|endoftext	'sneɪ.'kɛn.dəʊf.`tɛk.'stɛn.dəʊf.`tɛk.'stɛn.dəʊf.`tɛk.'stɛn.dəʊf.`tɛk.'stɛn.dəʊf.`tɛk.'stɛn.dəʊf.`tɛk.'stɛn.dəʊf.`tɛk.'stɛn.dəʊf.`tɛk.'stɛn.dəʊf.`tɛk.'stɛn.dəʊf.`tɛk.'stɛn.dəʊf.`tɛk.'stɛn.dəʊf.`tɛk.'stɛn.dəʊf.`tɛk.'stɛn.dəʊf.`tɛkst
rest—what	'ɹɛs.'twɑt
forth.<|endoftext|><|endoftext|><|endoftext|><|endoftext|><|endoftext|><|endoftext|><|endoftext|><|endoftext|><|endoftext|><|endoftext|><|endoftext|><|endoftext|><|endoftext|><|endoftext|><|endoftext	'fɔː.'θɛn.dəʊf.`tɛk.'stɛn.dəʊf.`tɛk.'stɛn.dəʊf.`tɛk.'stɛn.dəʊf.`tɛk.'stɛn.dəʊf.`tɛk.'stɛn.dəʊf.`tɛk.'stɛn.dəʊf.`tɛk.'stɛn.dəʊf.`tɛk.'stɛn.dəʊf.`tɛk.'stɛn.dəʊf.`tɛk.'stɛn.dəʊf.`tɛk.'stɛn.dəʊf.`tɛk.'stɛn.dəʊf.`tɛk.'stɛn.dəʊf.`tɛk.'stɛn.dəʊf.`tɛkst
of.<|endoftext|><|endoftext|><|endoftext|><|endoftext|><|endoftext|><|endoftext|><|endoftext|><|endoftext|><|endoftext|><|endoftext|><|endoftext|><|endoftext|><|endoftext|><|endoftext	'ɑ.'vɛn.dəʊf.`tɛk.'stɛn.dəʊf.`tɛk.'stɛn.dəʊf.`tɛk.'stɛn.dəʊf.`tɛk.'stɛn.dəʊf.`tɛk.'stɛn.dəʊf.`tɛk.'stɛn.dəʊf.`tɛk.'stɛn.dəʊf.`tɛk.'stɛn.dəʊf.`tɛk.'stɛn.dəʊf.`tɛk.'stɛn.dəʊf.`tɛk.'stɛn.dəʊf.`tɛk.'stɛn.dəʊf.`tɛk.'stɛn.dəʊf.`tɛkst
fall.—and	'fɔː.'lænd
die.<|endoftext|><|endoftext|><|endoftext|><|endoftext|><|endoftext|><|endoftext|><|endoftext|><|endoftext|><|endoftext|><|endoftext|><|endoftext|><|endoftext|><|endoftext|><|endoftext	'daɪ.'ɛn.dəʊf.`tɛk.'stɛn.dəʊf.`tɛk.'stɛn.dəʊf.`tɛk.'stɛn.dəʊf.`tɛk.'stɛn.dəʊf.`tɛk.'stɛn.dəʊf.`tɛk.'stɛn.dəʊf.`tɛk.'stɛn.dəʊf.`tɛk.'stɛn.dəʊf.`tɛk.'stɛn.dəʊf.`tɛk.'stɛn.dəʊf.`tɛk.'stɛn.dəʊf.`tɛk.'stɛn.dəʊf.`tɛk.'stɛn.dəʊf.`tɛkst
greater.<|endoftext|><|endoftext|><|endoftext|><|endoftext|><|endoftext|><|endoftext|><|endoftext|><|endoftext|><|endoftext|><|endoftext|><|endoftext|><|endoftext|><|endoftext	'ɡɹeɪ.tʌ.'ɛn.dəʊf.`tɛk.'stɛn.dəʊf.`tɛk.'stɛn.dəʊf.`tɛk.'stɛn.dəʊf.`tɛk.'stɛn.dəʊf.`tɛk.'stɛn.dəʊf.`tɛk.'stɛn.dəʊf.`tɛk.'stɛn.dəʊf.`tɛk.'stɛn.dəʊf.`tɛk.'stɛn.dəʊf.`tɛk.'stɛn.dəʊf.`tɛk.'stɛn.dəʊf.`tɛk.'stɛn.dəʊf.`tɛkst
hos	'həʊz
cease:—the	'sis.'ðʌ
out.<|endoftext|><|endoftext|><|endoftext|><|endoftext|><|endoftext|><|endoftext|><|endoftext|><|endoftext|><|endoftext|><|endoftext|><|endoftext|><|endoftext|><|endoftext|><|endoftext|><|endoftext	'aʊ.'tɛn.dəʊf.`tɛk.'stɛn.dəʊf.`tɛk.'stɛn.dəʊf.`tɛk.'stɛn.dəʊf.`tɛk.'stɛn.dəʊf.`tɛk.'stɛn.dəʊf.`tɛk.'stɛn.dəʊf.`tɛk.'stɛn.dəʊf.`tɛk.'stɛn.dəʊf.`tɛk.'stɛn.dəʊf.`tɛk.'stɛn.dəʊf.`tɛk.'stɛn.dəʊf.`tɛk.'stɛn.dəʊf.`tɛk.'stɛn.dəʊf.`tɛk.'stɛn.dəʊf.`tɛkst
forth.<|endoftext|><|endoftext|><|endoftext|><|endoftext|><|endoftext|><|endoftext|><|endoftext|><|endoftext|><|endoftext|><|endoftext|><|endoftext|><|endoftext|><|endoftext|><|endoftext	'fɔː.'θɛn.dəʊf.`tɛk.'stɛn.dəʊf.`tɛk.'stɛn.dəʊf.`tɛk.'stɛn.dəʊf.`tɛk.'stɛn.dəʊf.`tɛk.'stɛn.dəʊf.`tɛk.'stɛn.dəʊf.`tɛk.'stɛn.dəʊf.`tɛk.'stɛn.dəʊf.`tɛk.'stɛn.dəʊf.`tɛk.'stɛn.dəʊf.`tɛk.'stɛn.dəʊf.`tɛk.'stɛn.dəʊf.`tɛk.'stɛn.dəʊf.`tɛkst
remains.<|endoftext|><|endoftext|><|endoftext|><|endoftext|><|endoftext|><|endoftext|><|endoftext|><|endoftext|><|endoftext|><|endoftext|><|endoftext|><|endoftext|><|endoftext	ɹɪ.'meɪn.'zɛn.dəʊf.`tɛk.'stɛn.dəʊf.`tɛk.'stɛn.dəʊf.`tɛk.'stɛn.dəʊf.`tɛk.'stɛn.dəʊf.`tɛk.'stɛn.dəʊf.`tɛk.'stɛn.dəʊf.`tɛk.'stɛn.dəʊf.`tɛk.'stɛn.dəʊf.`tɛk.'stɛn.dəʊf.`tɛk.'stɛn.dəʊf.`tɛk.'stɛn.dəʊf.`tɛk.'stɛn.dəʊf.`tɛkst
fire-beaten	'faɪ.ʌ.'bi.tʌn
die.<|endoftext|><|endoftext|><|endoftext|><|endoftext|><|endoftext|><|endoftext|><|endoftext|><|endoftext|><|endoftext|><|endoftext|><|endoftext|><|endoftext|><|endoftext|><|endoftext|><|endoftext|><|endoftext	'daɪ.'ɛn.dəʊf.`tɛk.'stɛn.dəʊf.`tɛk.'stɛn.dəʊf.`tɛk.'stɛn.dəʊf.`tɛk.'stɛn.dəʊf.`tɛk.'stɛn.dəʊf.`tɛk.'stɛn.dəʊf.`tɛk.'stɛn.dəʊf.`tɛk.'stɛn.dəʊf.`tɛk.'stɛn.dəʊf.`tɛk.'stɛn.dəʊf.`tɛk.'stɛn.dəʊf.`tɛk.'stɛn.dəʊf.`tɛk.'stɛn.dəʊf.`tɛk.'stɛn.dəʊf.`tɛk.'stɛn.dəʊf.`tɛkst
shine.<|endoftext|><|endoftext|><|endoftext|><|endoftext|><|endoftext|><|endoftext|><|endoftext|><|endoftext|><|endoftext|><|endoftext|><|endoftext|><|endoftext|><|endoftext	'ʃaɪ.'nɛn.dəʊf.`tɛk.'stɛn.dəʊf.`tɛk.'stɛn.dəʊf.`tɛk.'stɛn.dəʊf.`tɛk.'stɛn.dəʊf.`tɛk.'stɛn.dəʊf.`tɛk.'stɛn.dəʊf.`tɛk.'stɛn.dəʊf.`tɛk.'stɛn.dəʊf.`tɛk.'stɛn.dəʊf.`tɛk.'stɛn.dəʊf.`tɛk.'stɛn.dəʊf.`tɛk.'stɛn.dəʊf.`tɛkst
fall.<|endoftext|><|endoftext|><|endoftext|><|endoftext|><|endoftext|><|endoftext|><|endoftext|><|endoftext|><|endoftext|><|endoftext|><|endoftext|><|endoftext|><|endoftext|><|endoftext	'fɔː.'lɛn.dəʊf.`tɛk.'stɛn.dəʊf.`tɛk.'stɛn.dəʊf.`tɛk.'stɛn.dəʊf.`tɛk.'stɛn.dəʊf.`tɛk.'stɛn.dəʊf.`tɛk.'stɛn.dəʊf.`tɛk.'stɛn.dəʊf.`tɛk.'stɛn.dəʊf.`tɛk.'stɛn.dəʊf.`tɛk.'stɛn.dəʊf.`tɛk.'stɛn.dəʊf.`tɛk.'stɛn.dəʊf.`tɛk.'stɛn.dəʊf.`tɛkst
black.<|endoftext|><|endoftext|><|endoftext|><|endoftext|><|endoftext|><|endoftext|><|endoftext|><|endoftext|><|endoftext	'blæ.'kɛn.dəʊf.`tɛk.'stɛn.dəʊf.`tɛk.'stɛn.dəʊf.`tɛk.'stɛn.dəʊf.`tɛk.'stɛn.dəʊf.`tɛk.'stɛn.dəʊf.`tɛk.'stɛn.dəʊf.`tɛk.'stɛn.dəʊf.`tɛk.'stɛn.dəʊf.`tɛkst
dark.<|endoftext|><|endoftext|><|endoftext|><|endoftext|><|endoftext|><|endoftext|><|endoftext|><|endoftext|><|endoftext|><|endoftext|><|endoftext|><|endoftext|><|endoftext|><|endoftext|><|endoftext|><|endoftext	'dɑ.'kɛn.dəʊf.`tɛk.'stɛn.dəʊf.`tɛk.'stɛn.dəʊf.`tɛk.'stɛn.dəʊf.`tɛk.'stɛn.dəʊf.`tɛk.'stɛn.dəʊf.`tɛk.'stɛn.dəʊf.`tɛk.'stɛn.dəʊf.`tɛk.'stɛn.dəʊf.`tɛk.'stɛn.dəʊf.`tɛk.'stɛn.dəʊf.`tɛk.'stɛn.dəʊf.`tɛk.'stɛn.dəʊf.`tɛk.'stɛn.dəʊf.`tɛk.'stɛn.dəʊf.`tɛk.'stɛn.dəʊf.`tɛkst
earth.<|endoftext|><|endoftext|><|endoftext|><|endoftext|><|endoftext|><|endoftext|><|endoftext|><|endoftext|><|endoftext|><|endoftext|><|endoftext|><|endoftext|><|endoftext|><|endoftext	'əː.'θɛn.dəʊf.`tɛk.'stɛn.dəʊf.`tɛk.'stɛn.dəʊf.`tɛk.'stɛn.dəʊf.`tɛk.'stɛn.dəʊf.`tɛk.'stɛn.dəʊf.`tɛk.'stɛn.dəʊf.`tɛk.'stɛn.dəʊf.`tɛk.'stɛn.dəʊf.`tɛk.'stɛn.dəʊf.`tɛk.'stɛn.dəʊf.`tɛk.'stɛn.dəʊf.`tɛk.'stɛn.dəʊf.`tɛk.'stɛn.dəʊf.`tɛkst
dayfall	'deɪ.fɔːl
see.<|endoftext|><|endoftext|><|endoftext|><|endoftext|><|endoftext|><|endoftext|><|endoftext|><|endoftext|><|endoftext|><|endoftext	'si.'ɛn.dəʊf.`tɛk.'stɛn.dəʊf.`tɛk.'stɛn.dəʊf.`tɛk.'stɛn.dəʊf.`tɛk.'stɛn.dəʊf.`tɛk.'stɛn.dəʊf.`tɛk.'stɛn.dəʊf.`tɛk.'stɛn.dəʊf.`tɛk.'stɛn.dəʊf.`tɛk.'stɛn.dəʊf.`tɛkst
pass.<|endoftext|><|endoftext|><|endoftext|><|endoftext|><|endoftext|><|endoftext|><|endoftext|><|endoftext|><|endoftext|><|endoftext|><|endoftext|><|endoftext|><|endoftext|><|endoftext|><|endoftext|><|endoftext|><|endoftext	'pæ.'sɛn.dəʊf.`tɛk.'stɛn.dəʊf.`tɛk.'stɛn.dəʊf.`tɛk.'stɛn.dəʊf.`tɛk.'stɛn.dəʊf.`tɛk.'stɛn.dəʊf.`tɛk.'stɛn.dəʊf.`tɛk.'stɛn.dəʊf.`tɛk.'stɛn.dəʊf.`tɛk.'stɛn.dəʊf.`tɛk.'stɛn.dəʊf.`tɛk.'stɛn.dəʊf.`tɛk.'stɛn.dəʊf.`tɛk.'stɛn.dəʊf.`tɛk.'stɛn.dəʊf.`tɛk.'stɛn.dəʊf.`tɛk.'stɛn.dəʊf.`tɛkst
before.<|endoftext|><|endoftext|><|endoftext|><|endoftext|><|endoftext|><|endoftext|><|endoftext|><|endoftext	bɪ.'fɔː.'ɛn.dəʊf.`tɛk.'stɛn.dəʊf.`tɛk.'stɛn.dəʊf.`tɛk.'stɛn.dəʊf.`tɛk.'stɛn.dəʊf.`tɛk.'stɛn.dəʊf.`tɛk.'stɛn.dəʊf.`tɛk.'stɛn.dəʊf.`tɛkst
appear.<|endoftext|><|endoftext|><|endoftext|><|endoftext|><|endoftext|><|endoftext|><|endoftext|><|endoftext|><|endoftext|><|endoftext|><|endoftext|><|endoftext|><|endoftext	ʌ.'peɪ.ʌ.'ɛn.dəʊf.`tɛk.'stɛn.dəʊf.`tɛk.'stɛn.dəʊf.`tɛk.'stɛn.dəʊf.`tɛk.'stɛn.dəʊf.`tɛk.'stɛn.dəʊf.`tɛk.'stɛn.dəʊf.`tɛk.'stɛn.dəʊf.`tɛk.'stɛn.dəʊf.`tɛk.'stɛn.dəʊf.`tɛk.'stɛn.dəʊf.`tɛk.'stɛn.dəʊf.`tɛk.'stɛn.dəʊf.`tɛkst
3—how	'θɹi.'haʊ
world.—i	'wəːl.'daɪ
fall—<|endoftext|><|endoftext|><|endoftext|><|endoftext|><|endoftext|><|endoftext|><|endoftext|><|endoftext|><|endoftext|><|endoftext|><|endoftext|><|endoftext|><|endoftext|><|endoftext	'fɔː.'lɛn.dəʊf.`tɛk.'stɛn.dəʊf.`tɛk.'stɛn.dəʊf.`tɛk.'stɛn.dəʊf.`tɛk.'stɛn.dəʊf.`tɛk.'stɛn.dəʊf.`tɛk.'stɛn.dəʊf.`tɛk.'stɛn.dəʊf.`tɛk.'stɛn.dəʊf.`tɛk.'stɛn.dəʊf.`tɛk.'stɛn.dəʊf.`tɛk.'stɛn.dəʊf.`tɛk.'stɛn.dəʊf.`tɛk.'stɛn.dəʊf.`tɛkst
darkness,<|endoftext|><|endoftext|><|endoftext|><|endoftext|><|endoftext|><|endoftext|><|endoftext|><|endoftext|><|endoftext|><|endoftext|><|endoftext|><|endoftext	'dɑk.nʌ.'sɛn.dəʊf.`tɛk.'stɛn.dəʊf.`tɛk.'stɛn.dəʊf.`tɛk.'stɛn.dəʊf.`tɛk.'stɛn.dəʊf.`tɛk.'stɛn.dəʊf.`tɛk.'stɛn.dəʊf.`tɛk.'stɛn.dəʊf.`tɛk.'stɛn.dəʊf.`tɛk.'stɛn.dəʊf.`tɛk.'stɛn.dəʊf.`tɛk.'stɛn.dəʊf.`tɛkst
10—sacrament	'tɛn.'sæ.kɹʌ.mʌnt
hand.<|endoftext|><|endoftext|><|endoftext|><|endoftext|><|endoftext|><|endoftext|><|endoftext|><|endoftext|><|endoftext|><|endoftext	'hæn.'dɛn.dəʊf.`tɛk.'stɛn.dəʊf.`tɛk.'stɛn.dəʊf.`tɛk.'stɛn.dəʊf.`tɛk.'stɛn.dəʊf.`tɛk.'stɛn.dəʊf.`tɛk.'stɛn.dəʊf.`tɛk.'stɛn.dəʊf.`tɛk.'stɛn.dəʊf.`tɛk.'stɛn.dəʊf.`tɛkst
it.<|endoftext|><|endoftext|><|endoftext|><|endoftext|><|endoftext|><|endoftext|><|endoftext|><|endoftext|><|endoftext|><|endoftext|><|endoftext|><|endoftext|><|endoftext|><|endoftext	'ɪ.'tɛn.dəʊf.`tɛk.'stɛn.dəʊf.`tɛk.'stɛn.dəʊf.`tɛk.'stɛn.dəʊf.`tɛk.'stɛn.dəʊf.`tɛk.'stɛn.dəʊf.`tɛk.'stɛn.dəʊf.`tɛk.'stɛn.dəʊf.`tɛk.'stɛn.dəʊf.`tɛk.'stɛn.dəʊf.`tɛk.'stɛn.dəʊf.`tɛk.'stɛn.dəʊf.`tɛk.'stɛn.dəʊf.`tɛk.'stɛn.dəʊf.`tɛkst
burn.<|endoftext|><|endoftext|><|endoftext|><|endoftext|><|endoftext|><|endoftext|><|endoftext|><|endoftext|><|endoftext|><|endoftext|><|endoftext|><|endoftext|><|endoftext|><|endoftext	'bəː.'nɛn.dəʊf.`tɛk.'stɛn.dəʊf.`tɛk.'stɛn.dəʊf.`tɛk.'stɛn.dəʊf.`tɛk.'stɛn.dəʊf.`tɛk.'stɛn.dəʊf.`tɛk.'stɛn.dəʊf.`tɛk.'stɛn.dəʊf.`tɛk.'stɛn.dəʊf.`tɛk.'stɛn.dəʊf.`tɛk.'stɛn.dəʊf.`tɛk.'stɛn.dəʊf.`tɛk.'stɛn.dəʊf.`tɛk.'stɛn.dəʊf.`tɛkst
darkness.<|endoftext|><|endoftext|><|endoftext|><|endoftext|><|endoftext|><|endoftext|><|endoftext|><|endoftext|><|endoftext|><|endoftext	'dɑk.nʌ.'sɛn.dəʊf.`tɛk.'stɛn.dəʊf.`tɛk.'stɛn.dəʊf.`tɛk.'stɛn.dəʊf.`tɛk.'stɛn.dəʊf.`tɛk.'stɛn.dəʊf.`tɛk.'stɛn.dəʊf.`tɛk.'stɛn.dəʊf.`tɛk.'stɛn.dəʊf.`tɛk.'stɛn.dəʊf.`tɛkst
there."—matthew	ðəː.'dɑt.bʌk.`slæʃ.'mæ.θjʉː
is.<|endoftext|><|endoftext|><|endoftext|><|endoftext|><|endoftext|><|endoftext|><|endoftext|><|endoftext|><|endoftext|><|endoftext|><|endoftext	'ɪ.'zɛn.dəʊf.`tɛk.'stɛn.dəʊf.`tɛk.'stɛn.dəʊf.`tɛk.'stɛn.dəʊf.`tɛk.'stɛn.dəʊf.`tɛk.'stɛn.dəʊf.`tɛk.'stɛn.dəʊf.`tɛk.'stɛn.dəʊf.`tɛk.'stɛn.dəʊf.`tɛk.'stɛn.dəʊf.`tɛk.'stɛn.dəʊf.`tɛkst
gone.<|endoftext|><|endoftext|><|endoftext|><|endoftext|><|endoftext|><|endoftext|><|endoftext|><|endoftext|><|endoftext|><|endoftext|><|endoftext|><|endoftext|><|endoftext|><|endoftext	'ɡɑ.'nɛn.dəʊf.`tɛk.'stɛn.dəʊf.`tɛk.'stɛn.dəʊf.`tɛk.'stɛn.dəʊf.`tɛk.'stɛn.dəʊf.`tɛk.'stɛn.dəʊf.`tɛk.'stɛn.dəʊf.`tɛk.'stɛn.dəʊf.`tɛk.'stɛn.dəʊf.`tɛk.'stɛn.dəʊf.`tɛk.'stɛn.dəʊf.`tɛk.'stɛn.dəʊf.`tɛk.'stɛn.dəʊf.`tɛk.'stɛn.dəʊf.`tɛkst
night.<|endoftext|><|endoftext|><|endoftext|><|endoftext|><|endoftext|><|endoftext|><|endoftext|><|endoftext|><|endoftext|><|endoftext|><|endoftext|><|endoftext	'naɪ.'tɛn.dəʊf.`tɛk.'stɛn.dəʊf.`tɛk.'stɛn.dəʊf.`tɛk.'stɛn.dəʊf.`tɛk.'stɛn.dəʊf.`tɛk.'stɛn.dəʊf.`tɛk.'stɛn.dəʊf.`tɛk.'stɛn.dəʊf.`tɛk.'stɛn.dəʊf.`tɛk.'stɛn.dəʊf.`tɛk.'stɛn.dəʊf.`tɛk.'stɛn.dəʊf.`tɛkst
shade.<|endoftext|><|endoftext|><|endoftext|><|endoftext|><|endoftext|><|endoftext|><|endoftext|><|endoftext|><|endoftext|><|endoftext|><|endoftext|><|endoftext|><|endoftext|><|endoftext|><|endoftext|><|endoftext	'ʃeɪ.'dɛn.dəʊf.`tɛk.'stɛn.dəʊf.`tɛk.'stɛn.dəʊf.`tɛk.'stɛn.dəʊf.`tɛk.'stɛn.dəʊf.`tɛk.'stɛn.dəʊf.`tɛk.'stɛn.dəʊf.`tɛk.'stɛn.dəʊf.`tɛk.'stɛn.dəʊf.`tɛk.'stɛn.dəʊf.`tɛk.'stɛn.dəʊf.`tɛk.'stɛn.dəʊf.`tɛk.'stɛn.dəʊf.`tɛk.'stɛn.dəʊf.`tɛk.'stɛn.dəʊf.`tɛk.'stɛn.dəʊf.`tɛkst
cry—<|endoftext|><|endoftext|><|endoftext|><|endoftext|><|endoftext|><|endoftext|><|endoftext|><|endoftext|><|endoftext|><|endoftext|><|endoftext|><|endoftext|><|endoftext	'kɹaɪ.'ɛn.dəʊf.`tɛk.'stɛn.dəʊf.`tɛk.'stɛn.dəʊf.`tɛk.'stɛn.dəʊf.`tɛk.'stɛn.dəʊf.`tɛk.'stɛn.dəʊf.`tɛk.'stɛn.dəʊf.`tɛk.'stɛn.dəʊf.`tɛk.'stɛn.dəʊf.`tɛk.'stɛn.dəʊf.`tɛk.'stɛn.dəʊf.`tɛk.'stɛn.dəʊf.`tɛk.'stɛn.dəʊf.`tɛkst
darkness.<|endoftext|><|endoftext|><|endoftext|><|endoftext|><|endoftext|><|endoftext|><|endoftext|><|endoftext|><|endoftext|><|endoftext|><|endoftext|><|endoftext|><|endoftext|><|endoftext|><|endoftext	'dɑk.nʌ.'sɛn.dəʊf.`tɛk.'stɛn.dəʊf.`tɛk.'stɛn.dəʊf.`tɛk.'stɛn.dəʊf.`tɛk.'stɛn.dəʊf.`tɛk.'stɛn.dəʊf.`tɛk.'stɛn.dəʊf.`tɛk.'stɛn.dəʊf.`tɛk.'stɛn.dəʊf.`tɛk.'stɛn.dəʊf.`tɛk.'stɛn.dəʊf.`tɛk.'stɛn.dəʊf.`tɛk.'stɛn.dəʊf.`tɛk.'stɛn.dəʊf.`tɛk.'stɛn.dəʊf.`tɛkst
hab	'hæb
day.<|endoftext|><|endoftext|><|endoftext|><|endoftext|><|endoftext|><|endoftext	'deɪ.'ɛn.dəʊf.`tɛk.'stɛn.dəʊf.`tɛk.'stɛn.dəʊf.`tɛk.'stɛn.dəʊf.`tɛk.'stɛn.dəʊf.`tɛk.'stɛn.dəʊf.`tɛkst
sun.<|endoftext|><|endoftext|><|endoftext|><|endoftext|><|endoftext|><|endoftext|><|endoftext|><|endoftext|><|endoftext|><|endoftext|><|endoftext|><|endoftext|><|endoftext|><|endoftext	'sʌ.'nɛn.dəʊf.`tɛk.'stɛn.dəʊf.`tɛk.'stɛn.dəʊf.`tɛk.'stɛn.dəʊf.`tɛk.'stɛn.dəʊf.`tɛk.'stɛn.dəʊf.`tɛk.'stɛn.dəʊf.`tɛk.'stɛn.dəʊf.`tɛk.'stɛn.dəʊf.`tɛk.'stɛn.dəʊf.`tɛk.'stɛn.dəʊf.`tɛk.'stɛn.dəʊf.`tɛk.'stɛn.dəʊf.`tɛk.'stɛn.dəʊf.`tɛkst
sky.<|endoftext|><|endoftext|><|endoftext|><|endoftext|><|endoftext|><|endoftext|><|endoftext|><|endoftext|><|endoftext|><|endoftext|><|endoftext|><|endoftext|><|endoftext|><|endoftext|><|endoftext|><|endoftext	'skaɪ.'ɛn.dəʊf.`tɛk.'stɛn.dəʊf.`tɛk.'stɛn.dəʊf.`tɛk.'stɛn.dəʊf.`tɛk.'stɛn.dəʊf.`tɛk.'stɛn.dəʊf.`tɛk.'stɛn.dəʊf.`tɛk.'stɛn.dəʊf.`tɛk.'stɛn.dəʊf.`tɛk.'stɛn.dəʊf.`tɛk.'stɛn.dəʊf.`tɛk.'stɛn.dəʊf.`tɛk.'stɛn.dəʊf.`tɛk.'stɛn.dəʊf.`tɛk.'stɛn.dəʊf.`tɛk.'stɛn.dəʊf.`tɛkst
more.<|endoftext|><|endoftext|><|endoftext|><|endoftext|><|endoftext|><|endoftext|><|endoftext|><|endoftext|><|endoftext|><|endoftext|><|endoftext|><|endoftext|><|endoftext|><|endoftext	'mɔː.'ɛn.dəʊf.`tɛk.'stɛn.dəʊf.`tɛk.'stɛn.dəʊf.`tɛk.'stɛn.dəʊf.`tɛk.'stɛn.dəʊf.`tɛk.'stɛn.dəʊf.`tɛk.'stɛn.dəʊf.`tɛk.'stɛn.dəʊf.`tɛk.'stɛn.dəʊf.`tɛk.'stɛn.dəʊf.`tɛk.'stɛn.dəʊf.`tɛk.'stɛn.dəʊf.`tɛk.'stɛn.dəʊf.`tɛk.'stɛn.dəʊf.`tɛkst
barren.<|endoftext|><|endoftext|><|endoftext|><|endoftext|><|endoftext|><|endoftext|><|endoftext|><|endoftext|><|endoftext|><|endoftext|><|endoftext|><|endoftext|><|endoftext	'bæ.ɹʌ.'nɛn.dəʊf.`tɛk.'stɛn.dəʊf.`tɛk.'stɛn.dəʊf.`tɛk.'stɛn.dəʊf.`tɛk.'stɛn.dəʊf.`tɛk.'stɛn.dəʊf.`tɛk.'stɛn.dəʊf.`tɛk.'stɛn.dəʊf.`tɛk.'stɛn.dəʊf.`tɛk.'stɛn.dəʊf.`tɛk.'stɛn.dəʊf.`tɛk.'stɛn.dəʊf.`tɛk.'stɛn.dəʊf.`tɛkst
heaven.<|endoftext|><|endoftext|><|endoftext|><|endoftext|><|endoftext|><|endoftext|><|endoftext|><|endoftext|><|endoftext|><|endoftext|><|endoftext|><|endoftext|><|endoftext	'hɛ.vʌ.'nɛn.dəʊf.`tɛk.'stɛn.dəʊf.`tɛk.'stɛn.dəʊf.`tɛk.'stɛn.dəʊf.`tɛk.'stɛn.dəʊf.`tɛk.'stɛn.dəʊf.`tɛk.'stɛn.dəʊf.`tɛk.'stɛn.dəʊf.`tɛk.'stɛn.dəʊf.`tɛk.'stɛn.dəʊf.`tɛk.'stɛn.dəʊf.`tɛk.'stɛn.dəʊf.`tɛk.'stɛn.dəʊf.`tɛkst
creature.<|endoftext|><|endoftext|><|endoftext|><|endoftext|><|endoftext|><|endoftext|><|endoftext|><|endoftext|><|endoftext|><|endoftext|><|endoftext|><|endoftext|><|endoftext|><|endoftext|><|endoftext|><|endoftext	'kɹi.tʃʌ.'ɛn.dəʊf.`tɛk.'stɛn.dəʊf.`tɛk.'stɛn.dəʊf.`tɛk.'stɛn.dəʊf.`tɛk.'stɛn.dəʊf.`tɛk.'stɛn.dəʊf.`tɛk.'stɛn.dəʊf.`tɛk.'stɛn.dəʊf.`tɛk.'stɛn.dəʊf.`tɛk.'stɛn.dəʊf.`tɛk.'stɛn.dəʊf.`tɛk.'stɛn.dəʊf.`tɛk.'stɛn.dəʊf.`tɛk.'stɛn.dəʊf.`tɛk.'stɛn.dəʊf.`tɛk.'stɛn.dəʊf.`tɛkst
you.<|endoftext|><|endoftext|><|endoftext|><|endoftext|><|endoftext|><|endoftext|><|endoftext|><|endoftext|><|endoftext|><|endoftext|><|endoftext|><|endoftext	'jʉː.'ɛn.dəʊf.`tɛk.'stɛn.dəʊf.`tɛk.'stɛn.dəʊf.`tɛk.'stɛn.dəʊf.`tɛk.'stɛn.dəʊf.`tɛk.'stɛn.dəʊf.`tɛk.'stɛn.dəʊf.`tɛk.'stɛn.dəʊf.`tɛk.'stɛn.dəʊf.`tɛk.'stɛn.dəʊf.`tɛk.'stɛn.dəʊf.`tɛk.'stɛn.dəʊf.`tɛkst
dead-white	'dɛ.'dwaɪt
you.—now	'jʉː.'naʊ
heavens,and	'hɛ.vʌn.zænd
light—<|endoftext|><|endoftext|><|endoftext|><|endoftext|><|endoftext|><|endoftext|><|endoftext|><|endoftext|><|endoftext|><|endoftext|><|endoftext|><|endoftext|><|endoftext|><|endoftext|><|endoftext	'laɪ.'tɛn.dəʊf.`tɛk.'stɛn.dəʊf.`tɛk.'stɛn.dəʊf.`tɛk.'stɛn.dəʊf.`tɛk.'stɛn.dəʊf.`tɛk.'stɛn.dəʊf.`tɛk.'stɛn.dəʊf.`tɛk.'stɛn.dəʊf.`tɛk.'stɛn.dəʊf.`tɛk.'stɛn.dəʊf.`tɛk.'stɛn.dəʊf.`tɛk.'stɛn.dəʊf.`tɛk.'stɛn.dəʊf.`tɛk.'stɛn.dəʊf.`tɛk.'stɛn.dəʊf.`tɛkst
pass.<|endoftext|><|endoftext|><|endoftext|><|endoftext|><|endoftext|><|endoftext|><|endoftext	'pæ.'sɛn.dəʊf.`tɛk.'stɛn.dəʊf.`tɛk.'stɛn.dəʊf.`tɛk.'stɛn.dəʊf.`tɛk.'stɛn.dəʊf.`tɛk.'stɛn.dəʊf.`tɛk.'stɛn.dəʊf.`tɛkst
black.<|endoftext|><|endoftext|><|endoftext|><|endoftext|><|endoftext|><|endoftext|><|endoftext|><|endoftext|><|endoftext|><|endoftext|><|endoftext|><|endoftext|><|endoftext|><|endoftext|><|endoftext|><|endoftext|><|endoftext	'blæ.'kɛn.dəʊf.`tɛk.'stɛn.dəʊf.`tɛk.'stɛn.dəʊf.`tɛk.'stɛn.dəʊf.`tɛk.'stɛn.dəʊf.`tɛk.'stɛn.dəʊf.`tɛk.'stɛn.dəʊf.`tɛk.'stɛn.dəʊf.`tɛk.'stɛn.dəʊf.`tɛk.'stɛn.dəʊf.`tɛk.'stɛn.dəʊf.`tɛk.'stɛn.dəʊf.`tɛk.'stɛn.dəʊf.`tɛk.'stɛn.dəʊf.`tɛk.'stɛn.dəʊf.`tɛk.'stɛn.dəʊf.`tɛk.'stɛn.dəʊf.`tɛkst
